19,12
154,8
85,64
20,40
140,8
94,117
135,11
5,42
83,1
18,22
11111111011a11111111111011011011101110000011111110111111100111101111102012010121112111b21b1022121101110111111111110111a12102221221100212201222001100220222111110
11110110100a01001010101111101111101111111111111111101010111111110111210022121021120020a21b2120110101101101101111011110a11022211220212102202221122200222212120111
11111011111a00111011111111111111111011011111101101111111111011110011001112222110211201a11b2001201021011111110101101111a11122201212011202020222012222122221211011
10111111101a11111111111110111111110010111101111111110111111000001111211111212112021212a22b0122222011111100011110011101a02111022122222201221211100210222211221101
11101111111a01111111111110111111111111011111111111111011011111111111211122011102122122b12b2122220121110111111011111111a01221122211222222122110022122200211211111
11111111010a11111110011111111001111110011111111011111100010111111111221120212000222020b01a2112001121101110110110111110a12011222002022220112011212122022222221111
11100110111a11110100111111111011100010011111000111111101111111111100220012012221122002b02b1101110021111100011011111011a11112211202222220021222222220112112201011
11102100212b20011112100010110022210101111110111111111110010111111111202102101012121111a22a1220111221111110001111110101a11200222220202121102210021102210222221111
11101101002b10212222021112112012111011010101011011111101001110110111022012211211112212a01b2210010110111011111111011101a11021122221212122020002021220022121e11111
11120120221a22202111111022221111101111111111111111011111001111111110121112110221200210a10b0102212101111111111111111111a11112222112222222202221222002221012201111
10101012010a12222120222111122001201111111110101111111110011011110111110110012112120012b00a0001111110101110011111101111a11212102222220221021220022002222220210100
11122201021b21222221212121111121110110111011111100111111010111111011111122121002121110b12a2120002211011101111101011111a01221022222201222220121222012222120111001
11111102222b1110012s110220120121210010101111111111111011010110011111101012101211002122a01a1221012211001101010111101100a12112212222020012022221202222010011220110
10112022011b02010102222111110011121011110110101111101011011111010101221210121200101111b00a0120112020111011111111011011a11101002112012202001022221221222222211101
11112211002a12012112112211211202011111111101011110111111011111111111212012112210222022a21b1100112201111111111111010111a10222122022222222222220210022211010121011
11011101212a22111111120101012021021111111111111111111110110111111010012212112211222022a01b2200112211111101011001111101a12100022112202222222200212112002222111111
10102111110a02211201200020112221021111111011110111111110101111111011011102122000111022a12b2222121201111111111111111111a12111210012221222211222222120221120101111
11111021220a21122111000011222122211011011111111111110010111010111110101111110011100111a01a1111101101100101010111110111a02222021222200020001121122022222202211110
11111211222b22221112122220201010011000101001111011111110111111111111110111101111110101a11a1111111110110111110111110111a12211222202222222221002101122122221111111
10112202101b01222222020120111122111111111011111101111110111111010111111111110111010100a11a1111011101110111110010100101a00112122122122212222212200200202021121101
11012212211bbbabababbbaaaabbaabb021111010111101111011111110111111111011111111010111111a00a1001110111110111110101110101a10111022102211202211212202222122211110110
1100011111202111200110201012022a111110110111111010101111110001101101110111011111010110a10a1001111011111111011001011111a02112222202100111122022102222122211011111
1012010121221120001202112200102b021110111110001110011111111111111111010111111111101101a11a1111111111111111001111111001a12021220220210222222222222222111211221111
1111202022012220111212212102121b121111111111101101111111111111111110111111111101111111a11a1110111111111111111011111110a12222210222022210221222202221211101001111
1112222122000021110212122122122a101111111111111110111111111111011111110111001100001110a11a1110111111111010101111101010a10222122202101121110201211110222111111101
1111202220222110111102220212102b222111111110011000010111111111110111111011011010111111a11a1110111111101011111111111010a12212001210201222222212101210022101101111
0111102222021212202022122212012b222201110111010110111011101110101111100100111111111010a11a1011111011111111110111011011a11121202120210221111122110112122110111111
2012220202022120022222222212221b211101101010111111111110011111111111111101011110111110a10a0101111100111101011111110111a11111100111111111001101111110111111101110
1211222020002221222102202022022b220210111111011100110011001111011000101011111011111111a11a1111111111111111111111010001a11011111111111011110111111011111111111110
1101100222020202222221020211001b022110110111111110110101111111111111101011110111111100a11a1011111111101101111101111111a11011100010001010111011100110110111101111
0202222220122220222022222222222a202201011111101111111111111111111101100111101111111111a11a0011111111101111101111010111a11010111110011111101011111101101111110110
2221120222212022102221122222022b122111111011111100101110111011011101111101111111111111a10a1111011110101110001111110111a01110111011011111110111110111110110111111
0222122222202221220222212011220b020011101111111100111101110110111111111101111111111111a10a1101000010100111001101101111a11111101111111110111111111111011110011111
0101102212221222101211210112102b122101101111111010010101111111101110011110011111111010a11a1101111110101111111111111100a11100111011011011110111111001111011111011
0222221222102002202220100012120b202111101110111001111111110111110111111111111100111111a10a0001011110000111101111111111a11111111111101110111100111111010111111111
2201102222212220222202112011212a001011101011110111110101111111111111111101111111110111a11a1001111011111111111101101111a11111010111111111111111110111011111111111
1122222202222222222122221220001b221001101011111010101111011111111110111110011111011111a10a1111010011011101111110111111a11100010111110101110011011011010111011111
2122121100122022222221021221122b211101101111011110011101011111111101011111111111010000a10a1110111111111011111010110111a10011111111111111110001011110111100111111
2120221120222221222002221111201b122110110111010101111111101111111110111110110111111111a11a1100110000001101111111110101a11111001110110110101111101011011110011111
1011212222212100102122110100110a110210111101000110111011011111110100010111111011011111a10a1111101110111010111011101000a11111111110110111111111010101011111111110
0211121222222222222222221200222a221210110111111111111111101111110111101011111100111111a11a1111111111111111111110110001aaaaaaaaaaaaaaaaaaaaa111101101111111111110
2122120221222022102101112210122b212111001101011111111101111110101111101111111100111111a01a101111101111111101111111011111111111111111011100a100111110111111111101
2000221121221220222022222021122b222211111110011100111011111111111111010100111011011111a11a110101110111101100111100001111111111110100111111a111101110101101101111
1102200201222112220200220222212a201111100110111101110111111111111111110111111110101110a11a111111111101111111101101111111010111100001111111a010111011011011110111
0210001111222022222101210212220a112210111111111111111101111111011010111011111111011111a11a111100110110110101111111101101011111111111110110a101100110110111001111
1201221012112222110222111102211b211211010110010110101111101101011111101111011111111111a01a111111101011111101111111011101111100011110111011a111101001110110110111
0201220222222002111011212121112a220011111111111111011011111111101111111100111111111111a01a110011111111111010110111111111111111111110101010a011011110001111011001
0011121212222201002222112112221a121211101001110111011011111111111111111111101101111011a11a110111110111011011101101100101110011111001111101a111100111011111110101
1121022010202222212022202021021b211210111011101111111111110011110011110100111111111111a10a101101111101101111111001111111111101110011110111a111111101111111110111
2010012121220220222222221112221a212210101000111100101111111111110010012212122112010212b20a021102112111111111101111101110111111111111001110a110011111111110001101
2112221201101022211220222101110a222111010111111111110111111111111111110111102012022021a11b122011111210111101111011011011110011111111001101a110101001101111111110
0111020201110122020110211100112b210111001111110101101110101111100111002202112011222020b20b022121202221111111111101110101101111001111111101a111111110110111111110
2021022200022011121220102211011a121111001011101110110111111110011110010122021202102021a10a120201010211001111101111110110001011101011011100a100111111010100011111
2121011120212222212220002122120a222011010111010110110110011111111011112010111111211221b22a200111122100011101111101111111111111111111111100a110111111111111111010
2222222201222221102221001000121b121211110111111111111011101111001111110020122201210112a22a012201112111111111111100111010111011111111111111a111110111101111110111
1021102222202122112022212211011a212201111101111100110111111110011111111200110011011011a21b101121121010101111101111111101110111111111111111a111111111111111011111
2121012201001220221121110110111a101111101111111101110101111111110010001102202222102212a11a010120011111111111111111101110001111111101011111a111101101111101011111
1101001121221200210211111111111a111111111101110101111100111111110111012122010102121110b22b021221221221110111111110101100111111111111111111a111000111011111100110
1111111111011001111111011111111a111111111100111101111111111101111101112200010111011211a11a222121001201110011110000110111111110010010111110a111111111111011111111
1111110111110011101111111011100a011011110011011101101011010111111011112102121021020201b21b222110002121100111111111111111011101110111010110a111110011000110111111
1111011110010010110111011110011a101011101111111110111101110111111011110101112222020212b22b021221221011111111101111101111110110111111011011a111111011101111110111
1011111111011000011000111110111a110111111111011111110110111110111010101202212222221122b12b122202221211111011111111111111001111111111111011a101111101110111011101
1111011011111111100011111111111a111001001011111010111100101111110001112212121112110211b10a220112121111111111001001111111101101111111111111a101111111111111001110
1100111011110111111111011110100a101111010111001111110111111111011111111020212122122222a02a122201011200011101110111001111101101111110110110a110111111011100110101
1111111111111111111101011011111a101100101010111110101111111111011010012212221111000022b22b212012121121101110000111101111001010101110011100a011111111101110101110
1101111111110011110111100110101a111011111111111001111111011111111100100121112221211112a21a110221121001111111111111111111111111111110111010a110111010101111011111
0111010111010111111111111111111a111011111101111110101101101111111111111222010211221212a12b202121101111100111101111110110111111111111111111a000101111110111011011
1111111001101101111101111011110a110101111111110110110101111111111001111022222121021121b00a112222122221011101011010111101110011111101011111a110111011011111101111
1111111101111101111111111001011a111011111101111110111111101111100100111222212212011122a11a121121102110010110101011011111110111010111110110a111111110110111111011
1101110011111111110011111111101a101111111111111110111110110110110010112012111022221012a11a212211122121011111111111111011111011111111110111a110011101110111111111
1111111111111100110111111110111a111011111111011101111111011111111111112020111110011222a00a122011102201101111011111010111111111111011011101a111111011011110011110
0110111111101110001011011011100a111111010111111110101111011000011111112222002112001122b20b021211122121110011101101101111110111011111111110a111111111011111110110
1111110111111001110111111101110a111111111101111010100011010011011110112002021021022122a21b102211101221111111111111111010101010111111101111a101111111111111101011
1111110111111100101110101111011a101111111111111111011110111110101111112210222121210111b22b221110001221110111101111111111111111111011110101a110010111001010101110
1111111111111111010010111111011a110111110011111011111110111100110011111221121121110201b11a220002202121111111001111110111111111111011010111a111101101101100001101
1111101111111111101111111111111a111011111011100011000110111110111101112111010102222022b11a112012112201111011111101111110111111100111010001a111011111011111111111
1110110111110111111110111101010a111111110111111111101111111111111111110101220111111021a11b122121021021101111110111001111010111111011101111a101111011111001111110
1111100111011111110011110111110a111111101111111111111111000111110101011221210212011002b10a120101001101111111111111011001111110111011111101a111101101110111111110
1011110011111111101111111111111a111011101010111110001101110101110111011220012011011021b22b102211121101111101101111111111111011011100110111a111111111011111100111
1111010110010011001111111111101a110111001111111010010111110111100111112110000211000021b00b211221111100111110101010101011111111111111100011a100011111111111111101
1111111111111110011101110110111a011111111001111110101011101111111100110011111111111111a10a001110101101011010111111111100111101101111111110a111101111111001111111
1011111110111101110111111111010a000110011111101101111111111110111110110111100111011010a10a110000111111111110011011111111111101111111001111a011110101111011110111
1011100111110111111111111111101a011101011111110111101101011101011011111111101011010111a11a111111111011111011011111011111111111111101101001a101111111111110111111
1111111111110011111111110111111a111101111111110001111110011000111011110101101101001111a11a010000100111111110111010111101111101111101011011a111101111111111111010
0101111111111111111110111111111a111011100011111011111111011111110110111111111111111111a11a111111101101011101011111111111111111111111110110a000111010101101011111
1111111111110110010101011101111a111111101010011111101111111110010101111101111011111111a11a011111111110101100011011111010111100101111111111a111111110110100110111
1000111100111111110001111011110a111011111101111110110011111011110111111111111011111110a01a001111111111111111101011011110111111111101101111a101111111111111110110
1111111100101001111101111011111a111111111111110111111111001111111101111111110101011100a11a111110110111111111111110111111100111110011011111a101111011111100101101
1111111111010111101111111001111a111001111110010010100111111111011111111100111111110111a11a011111101110111111111111011111110011100110101110a111111101101010110011
0110101100110110110111011111101a101010011111110111111111110011110110111111111110111111a11a011001011101110111111111111011101111101111111101a110111111111111101111
1111111111111111111111111110111a111001111101111111111101011111001111111111011011101111a11a111111011101101001100111111111100110110001110111a110111011111101111110
0101110110111111111111110111111a001101101110011111111110110110111111111111001110100111a11a010101111111011110001101111001101100111101010111a111111011111110110011
1011110111111111011100001111111a011101111111100011101110111011111101111111111111101101a11a111111110100110101101111011110110111111010111110a111110111111111111111
1110111111101101110110111011101a111111110111101000011011011011110110011111111110110111a01a111111011111111101111111111111010111111111111111a111011111110101111111
0010000111001101110110111101101a101111101111010011111111111010111011111111011101011111a11a111111111000110101111111111011111111011111111111a011110111110110111111
1010010011011110111111110011111a111110011111111110111111110110111111011101101011101111a11a011100111111011111101111110011101101111111111100a100110111111111011111
1111101111001111100111110111111a101011001101001010101010111110011010111100101111010011a11a101111010111101011101110111001111111001011110111a111111111111101010101
1111110100010011111111100010111a110011111011101010011101011111110011111111111011110111a01a110111111111111111111111111111101111100111111111a101111110010110010011
0111111001111111011110010111111a111111010011110111011101111101111111111101111111011101a11a011110101110111111111110010111111111111111011111a011110111111111010111
0111111011110101011111001111010a111111111110010101111111111011111011111111101011011111a10a110110110101111111111101101111011111111111111111a111111111111111011111
1011011001111111111011110111101a110001111111011111011111110111111111011111011111111101a10a111111010111010111010111011111100111111111110111aaaaaaaaaaaaaaaaaaaaaa
0111110101010111111001101111111a101101111111111101111111111001011110111110011111111111a10a1111111111101111111110111101111111111010101110110111111111011111111111
1111011101111011110111011111100a111011111111101011011111111011100011011111011111121220b21b2220211101100102122010001110111111111111011001111111011111111111111111
1010011111111011111011111110100a001111111111111111110101111111111111110111111111221112b12b2202022022020020012211111011111111111111111101111001110110110111111101
1111101010111011100001111111101a110111110111111111111111110101111011011001101012110211b12b1021201221212212211210111111001111011110111111111111011111111001110110
1111110111110111110101111111111a111100111011111110011100111111111111111101111111020111a20b1222210021111211222201111110111100011111101111110111011111111111111011
1111011111111011110101111111101a101010101101111110111111000111111111111101111111020110b21a2012222201022200100110111001011011011111111111010011100100111110110111
1111111110111101111011111110111a111101111111111111011110111110111111100111011112021122a12a1111121212120210201110111111111111111011111111111111111111111111111111
0111111110111111111011010111111a110111111111111111111111101111111111101111010112221000b11a1221102022221012211111111111101111111110101111111111111111101110111111
1111111011101101111111100111111a001111110011011111111111101001011111110101111111020120b01a1222221220211111020011111011101111111111111110111001111111111101110111
1111111111101010111101100100111a001111101111110101111110111111111111011111111112021222a21b2022222212122222011211011111111110111100110111111011111111111111111111
1111111111110001111111111111110a001101111110111111111111111111111011100111110112022210b20a1221221102012202012111110111110111011110111111111111111111001111101101
1100111111111101110111111110111a100110111110011111111111111111110111101000111111201210a11a0102111122100022021111111011111111110111111111111011111111101111111110
1111110010001111111111111011110a111110111111111011111001111010110011111101111111121200a20b2112012021122111211011110111111101111111011111111111111111111011111111
1111011101110111110111111101100a011101101110101111111110111111011111011011101010122111a11b1101121011222120011211111011010110011111110011110111111111111011111011
1111111111111100111110111111111a111110111101110111111111111111000101110111101111111212a12b0211011210120021112211111111111111111011010110101111111111110111111111
0110010011111111111001111111110a011111101110111101100101011111111111101101111111011000a11a2021202012111121211110101010111011110110011111011100110111101010010111
1111111111110101111111111111111a111101110111111010111111111111110110111111110102210210a01a0211211022222212222011110110111100110111111101100100101011111101111101
0101111111011110111101111101111a111101111111110001111101001001101111011111111111100102b11a0210021102111222121111111110101110000111011101101001011111111011111111
1011111010111111111101111100110a011011111110111111101000111111111011110011111111111011a11a1111111111001110111111111111111011101110110111111111111101101110001111
