-1,-1
-1,-1
31,43
88,90
149,57
104,86
107,1
91,23
116,51
8,92
111a101111110111010101111a11101111111111011111111111111011111111a11101001111111111101100110112211011112101210012210211101210111101111111100111111110111000011111
111a110111111111111010111a10110111111011101111111111111111000111a01100111111011110111111110122121112010121210101122210111121111111111011000110011111111101111110
110a011111101111101100011a00001011111111111111111101110011001111a01111101101110011111111111001220110010022212211102211122101111111111111111011100111011111011101
111a111010011100111011010a10010111111110111111111100111111011011a11101010101111111110010111122122112222221121211222112111220110111110111111001111101011111110111
100a011011101111110111001a11110110110100110110111111111111111010a11111110101111101111111101100100112222122102111112121000220101111101111100111111011010111010101
010a111111101110011111011a11111011101111101111000111110111111111a11001111101111100111101011111120111222121100111010011212121111111111101101100111110111101111111
111a011111100110111111011a10111110111111110111110111111111110010a11011111110111111101111111121111221220011202120111112121121011111111111011111110111110001111111
101a111111011111100100111a11111111111111000111111111011111111101a11111111111101111111101111122221020201211210120111101121221011101011111010101111101111111111111
011a001111111111100001001a01101111011111111111111111111111111111a11111101111200211212021222022212211121200120210112112111221111110101111111111111110111111111111
111a011111111011001111101a01111101111101101110011110111101010011a11011101010112120012021100122022102222222202110211211112200010011101111110111110010111011111101
110a101111111001101001101a10101001101110111011111111111111111111a01111111101210011220211112022022110121212212200220012212201011100111011010111101111111111111001
110a011100111111111011110a10101110010111111100111111111111001111a11101010101221002210202101120022011221222201220121020211121111101011111111110111110011101111001
111a101110111110111111111a11101111111011101101111011111101111111a10111111001120111202220211122021120122122222121121110222110111101101110110111010110111111101001
111a100111111101001111100a10111111010111111101001101111110111000a01111101111112212212212102122220012222102200112202122110221111011111111110111111011111101110111
111a101001011111011111111a11110111111111100110111111110111101101a01011111111211201112112102212122002222002221012222021121101110110011101101111111111111101111110
111a110111110111011111111a11111111001101111011111111111111011011a11111101111201211002121010110222222222122202012220012221121111111111110110111111011111001010111
110a110111101111111001110a01111011111110011101111010111101111000a11011101111022222012122002120122222011121201110000011221200111011111110100101110001011101010110
111a111111110011101110011a11011111101011110111111111111111110011a10111011101210210211110221211202010100122111111111111111111111111111101111111101011111110111100
111a101111011111111111110a11101111111011111001110111101111101110a11011111101201022201202101020011212210120011111111011011011111011111111110100111111010111111111
111a111011100110011111111a01111101010011111110111011110010011100a11111110101222112212221201112022120201212011111111010011110101111111111011011111111111111101111
000a101011111011001110111a10110111111110101111101101111101111011a11110111110102221122101212121112222121221011110011111011111011100101111111101111111111111111101
111a111111001011111011111a11111110101110111111111010101111011111a11111110111111122211012100022222111111201210001111111111110101111111110101110111010011000111111
110a110101110111111011011a01001101111110101011110111011110111100a00111111110220121202212121212212022112211111111111101110001110101111111001111111111110111101110
111a111111011111001111111a10011010011011111110110110110010110111a11111111111021011210020222121122202210102010111111101100111110111111110100111111110101111011111
111a111111111111111111100a11110101110101111111111101101111111111a11010101101202212121221122212110211222020211111101011111111111111111011101110011110101111100111
111a111100111110101111100a10110101111010111111011111111111110111a11111101111012112110212220212111122222211111111011111111101101111010001101111001100111101111111
110a110011100110111111111a10110111110110111111100110111011011111a11110111011121001221111022120012120110221111100111110011111111111110111111110111111011111101011
111a111100111010111110111a11010110100111110011111101110101011101a10111111011112112010222212022101100101122211011111111111010111111111111111101111111011010110111
010a111111110110222222011b11122210112220112001011110111101011111a11110110110112122121212121111010121211112210110111110111111111011111111111001001110011111111011
111a011111111111121112112a01202201210111101002211010111110111011a11111100011220201222201222122101112210210201110111011111111101111111111111111111001111111110111
100a010111111111020122000a11001110221020001122111101011110010111a11111111111202121212120112211122112101111211111011111111011101110101000111110111001111111101011
111a010011011111020210122b02211021001120110202101111101111101111a01101011111210202211011210202121101102022001110111111110111111110111001100111110101111100111111
010a111110110001210112221b00211222221212201211211111110101010111a11111111110112100102121200221210112001211101110111110111111111101101001100111111111111110111101
111a110101111111121111010a22110110101212111102211110111111110111a11111111111222202112222011121211111121122111111111111111111011111111111110111111011010110111111
111a111011110110202112111b01202021221221122101211111111111010111a01111101111112211112222200110012201210121211101011110111111111111101001101100011111101011011111
111a011111110111101211212a11000212112120010122011001111111110111a11101111110221122111022111222012121010110011110111111101110111011111111111101101011110111101110
111a110110011111210100211b02120211112011000222111100101101111111a11111111101201121010121001200012112222120020100110211001011210201201101111101101111100110111111
110a011111011111020021112b12211011101122022021001101111111111101a11110111011212212112111212111211002222022211011121212101210121201111111111011101111110011111101
111a100111101110021221112b10111121222022211211101111101011111111a00110110011022201021100000011220111222220210222222201011000212211221111111010111011101111011110
011a111111111011020222012a22221222001211122122211101010111011111a00011101111101100011100011111110111112021011221212111101021221211111011111111111111101111111111
011a101011111111111121120a12122121111111121010101111110111111111a11011111110111111101011011110101011110002111212222021121002200222111110111111110111111111011111
111a101110100101111122202b22010101101021121211211110101011011101a11111111111010111101111111101111111111101102110222022222012201121221100010110111111111111110111
001a101110011011110222020a11110112122021020111101111101101110111a11111111111001011100101111000101011122212211011112211112011222111100112211012120121112222202211
010a111111111111002120120b12121201122222111212111111100101011111a11111111110101111111111011111101111111120122111211010022222201111110001121112111012000121211111
011a010011101111112020110b10121112220222111020011111011101111001a11111111101111011111110100110110011112020202122212222211202111121101111122121202021212011121121
011a100111101111112121222b20122002122100111221211111101111110111a11111101111010100100001111101111111101122111210101112212011012012201101120201222121222111102111
111a111110101111112201102b22211021211211201222201111111111111111a11111011111011001011100110101111111110121110111111201212002110222021121100101202022122210221111
110a110111111111102110122a02212010111110221011111011011111111101a11101101011011100111010111101110011122202200112221021211100110202001110222112202100121222111110
111a110001111111212201002b21102012010210102121010111101101110100a11110111111011011101011011111111101121121210111011110112210021201121120021110120110112122120121
101a101111111111220221222a20021101201211222012210011111111111111a11000111111010111011110110111110111020112011121001211211111210111121110112012100222211221110121
011a111100111110102212202a12122012221221012122110111011011111111a10111111111111011001101111101111111011210102020210101211122001010121001210211222111212111211221
110a111010110011021221002b20221021022112101120000111010010001111a10111110111111111111010111110011111010121212000202111110102020010201001021210100122112211102121
110a100111111111201120210b21110211111112021012111111111110011101a11111111100111110011011011011010111122022211110122121122121211111020120200222111011122112221211
101a101010111011110011111a11102211221120201221211100011111111111a11110001110110111101111101111000111011020121211102010120101222102210022112211122102011112100211
111a111111101111022021112a01022020120100110211111111111111101111a11110101101111110010110111011111111011111112212021111022101221111211002020111211121111112212101
111a011111111110222021111a00200121122012210211111101101111111001a01011010110011111101111111111011111120111020011001021202021222200200002221111111022122122202211
111a111001100011221221200b10101212120212200111211111100101111111a10111111101111011111111111010011111100102221121121020221102110212111111022012111012202110222100
011a111111111111200100112b22201001221022221222211010110111111110a10010111010100111111111111111110111112022111120201001211010122211211022011111201211122211222110
100a111110111111002120121a22111100202201021122011111111101111110a1010011111111111111111111101011111011012211220112222201baabababbbabaaaaaaaaabbababababbaaababaa
111a101111011011101011011a01111101101111111111011100111101110101a0111011100111111011111100011111010102221022111221212111a022212220011121200221010102221111201221
111a101111111111101101111a11111100011110101111111110111011111101a1110111101111110011010101101101111012200212222121120122a202011100211121111212102211102120201120
101a011111011011111101111a01111100011111011110111111011110111011a1111110110001111111111100101101111002121112111021111222a211202212211122120212211002122102222111
010a010111111100111111111a11111111111111101111111111110101011111a1110111011011111111111011101101111110211101102200121221a022112111111102021212111221020221110101
111a111111111111111110111a01011111111111011101111110111111101010a1110011111111101101111101111101111100022111021212112011b221110220111101222112221111000202201010
101a011111010111111110111a11111111111001111111011111101111001101a0101111101111111111111111101001111112222202111121212200b110212120100122221020111111121221102220
100a111110111111101011111a11101111011110111111110010010011010101a1111111111111111111101101101101001011101222221102111222b210112101221111012021101210101012021211
101a111111101111101110100a11101010111111111011011111110111011111a1001100101101111101110111111101111112211102120210222122b222221102201122111022222212110221211021
111a111100010011011011101a11111111111111111011011111100111111110a1111110111100100100111111111011111111111111111101101111a011011111000121002121012120001221111121
111a111111111111010101111a11101111111111111111100111111100111110a1110101111011111101111111111101110111111111111111110110a111100011011121211121111211002202121221
101a110101111111111110010a11111111010111101111101110101011010110a1111101110101111111111111111011010110100110110101001111a101010111111110022021111121122212221221
111a101111111110011111011a11110111111111111101111111111111111111a1111111111111111100111111111111111111110111111111011100a011111111111002221222120122110222120210
111a111111111011001110111a11111111111100101101011101100000111011a1111101111111111111110001022211111001211121221111210110a101111111111111002100111211000202221221
101a111010111111111111111a10101000111111110111011011111100010111a1000000010111100110111110222212120212112010120101211111a111111011011111101121120112022012102221
110a111111110111111111101a10111111111111110100111111011111110111a0000111111101111111100111202111112112101210201021220012a111110110111101111111111111111111110111
111a111111101111110111111a11100010110111111100101101111111110111a0011111111111010111111012110101110212020212121121211010a101110011111100101100100111011111011110
101a101111101111100101011a11111110001001011110111111101011011111a1111111011212022102222221222021021001221222212010220012a110111111111111111111111010110011111100
111a101110011110111111111a11111111101001111010111011111011110100a1011011102211210112022102110122012102111221111111121201a111010101111111111111111111101111011011
111a101212021011112012021a01111111111111111111011111010011001101a1001100102012212100122122222222222221221111211101221122a001111111111110111000111111111001010111
002a201201221202011210110a10111111011111011110011111101010101110a1110111122202111210212001122021220221221002012111121121a011111111111111011111101110011110111111
112b022222122111211100121a10111011011111011111101011111111110111a0111110110201211102102200202122222202220011212021221200a101111011111000110111110011111110111101
221a021211110110220212111a11100111111101111011101111111011011111a1101111121112211211222220102102222012212112202211210202a100111011011111111111101111111111111111
111a200220022000122022210a01111110111110111001010111111010111111a1110001100021012021222212222110222221212011121011222011a111101011011100111101111111111111111110
001b001012001102100222211a10111111101010100111111110111111111111a1011110102121122222000112022222202012211110210012122011a010101110111011010111111110111111101111
221a222201211220102120011a10101100111110111101111111111111111011a1111111122101222121210111220012021220222121002221201201a110111111001101111011011111111110110111
211a212010022101120201021a11111010101011111101111111110111110010a1011101122212012121112022220022221200122020022121202212a100011011111111101101111101111111001111
210a002200211110201212011a01111111111111110110111111011010101010a1101111121211110222122212212222222212220022111010122021a011110011111111111101111111111110001111
101a212212211012210121111a11111101111101111110111011111111111111a1101111112121002112222112222021202222010120011120011101a110111111111110011110010111110111101111
121a100222121112121211211a11111011110111111111100110111111111111a1110111022100122111012211221222210000200200012011111020a100111101111011111011010111111111101111
201a022022210122222000220a11100111011111111011111111111111011101a1010110122011222220202102222202202222200201200112101122a111111111111011111111111111111101101111
112a021010211002111122001a11101011011101011110111011111011011111a1001111111021222112220001120122220201121101100020002202a111011011101100110100101011101101101101
210a222111011220010220211a01101111101111110111111111111111111011a0100001112011212112112002122222222221222012122222122111a110110011001110110111110101111101111111
111b120211111212020200201a11111011100111101101010111110011010111a1111111001022110102212210101120211122222202121222110222a111111111111011101111111111111111101100
212b210211221102202021201a01011011111101110111110111111111011111a0101101112212212022202020221220202221222221122210210112a010100101101100010010111111010111101011
121b010012121111112201200a11111111101010111110111111111101110111a1111101101000221121202210212220022002121121102111212101a101111111111111111110111100111111011111
210a222221112111212202221a11111111111011001100101001111111001111a1111111021211221222221112010022212210211020012211022011a011111111001111111011111111111111011110
201b112121121200101221111a01111111110101011110000111101111111101a1011011122121212112212002222202212222222000012010111112a111111011100111111100100001011011111110
221b210220120121212101021a11111101111111011111111101110111111100a1111110111110222201101012221012121121221201112002111212a111111111111111110111111011011110110111
121b121121122111110211210a11111111111110111111110111111011001111a1011110102010110201101212222220220122122212210221012021a111111111111011111011111111011111110110
111a221100201222122222021a11101111111111111101111111110011011110a1111111112121001212211222222202202122221001111212212022aaaaaaaaaaaaaaaaaaaaa1111110111011111011
021bbbaaabbbabbbaabbabaa1a01111111011111101111111011011111110111a111100112120012021012002212202002212220220110212102112101111101111111111111a1111111101111111110
11112200111001122010211b1a11011111111111011111110011111110110111a111111101122211200002002122222112222022211111120220211111111011111101111110a1110111110001101111
11120200211122122202111b1a11111111111111111011111111001111011111a111111111021121100101111211222222122220112201212120100110101111110111111111a1011111110110110111
11111210111022012220120b0a11111111111111011111101000111111111110a101111100020202021022021201211211021020110011101111111111111111111111111101a0111011011111111111
20211211020122120221212b1a11111111101010111111111110111110101101a110111101021011201201200220011112112221101111110111011111111011111101111111a1111101111111111101
22122102221122112120010a1a11011110111101111101110111111011111111a111111012021101212001120012111112110221111011111110111111011111111111111111a1011110001111111111
12122112012022222020011a1a11111111111111111101111110100011010011a110101001211112221122121121202002121221011111011111110111110011111101101101a1111111111111101011
22121212222102201112011a1a11010111111111111011111111110111111111a011110111111110110111111101101011111111110111111011101111101111111110111111a1110110101111111001
12020021220002010222110a0a11010101001101111111111111111111110001a111110101100111101111110011100110011100111111000010111110111111111111110011a1111111101111111111
11111011111011101111101a1a11111011001001011111111101000011111110a101111111110011110111111110111111101101111100111111101111101101111110011011a0101111111111100111
10111111111111111111111a1a11011111111111111011101111111110111101a111111101111111111011111111111101111111111111111100111101111100111111111111a1101011101011111111
11110100111111001011010a1a11111111110111111110111100101110001111a111110111111001111110011111011001100100111001111111111101111111101110111011a1110101111111111011
01110111010111010011110a1a11110110110111010111010110101111111111a110100111110011110101100011111001011111010110111111110101111110011111111110a0111111111101101111
10111110010111101110111a1a11000111110101111111111101111111001101a101111101101111111111111111101111111111110011111111011011001110111011011111a1101011111110101110
10111111111101100111111a1a11110111010111010111110111101110111111a011010111010001111110011111111101010011111111111101111101101111011111111111a1111111101011111111
11111100111111101111001a1a01011111110011101111011110111010101111a111111111111011110111111111111110001101101111111110111011001011111111111011a1011111111111111111
01101011110111101011111a1a11111110100111101111111111111101111101a111110010111110111110110010110101010111111101111110011111111111111100111110a1111100111011111111
10011111111101111110011a0a11111111110110111111100111110010011111a011111111111111110111101111111111101111010111101111111111011111111111001111a1101111110111111111
11101111111110110101111a1a11011111110111010110011111111101101111a011011111011111101101111111011110000111111111111111110110111011011111111110a1011111111110111111
11111111110111101110111a1a01011111111011111101111111111101111111a100111111111111111011011111011111111111101110101111111000111111101111011001a1010111101111110111
01111111110110110100111a0a01111111001111111000110111111111011101a011101111111111101111010101101110111010111111111111111111111111100011111011a1111001011101101101
