13,102
147,111
159,32
19,44
120,39
80,49
71,27
142,7
125,79
154,106
1011111011111111111011111111011011011011101000110111110111111111110110111110110101001101001111001111100111110100101110111101100120111100012122222212102221002101
1111111110111111111111011111110111011010110111111110010011101111101111011111111110010110111100010111111110110101001100111001111022222201200122212021102201101011
0110011111111111011111111111111111101111001111101101110111111100001011010011111110111111110011111111111111111111101111011111001120012212210122221210122121100111
1111111111011111111100111011101001111110110110110110110111001110011111111010111001111110111001111111111111111111111111101101011202022200201222211121110112120211
1111111001111111000111110111111110110111011111111110111101111001111111111111111111110101111101111111111111111111111001111111101212110222201110200000211120011211
1111101111110101001101101011110111111111010011111010110101111111110110011011111111011111111101111111111111110110101100001111101110112120012210212212101221100001
1111011111111111111111111111011111101001111111101010010100111001111011111011111001111100111111100111101111011111111111011110111220111111220111121022111110212110
1111111110110110111111111111110111011111110111000111010101111011011111101111101111111101010110111111111111111110110111100101011021021000111011111121212011122101
1010111111111101111100011111111011111101000101111111101111100111111111111110011111111111111111110100111101010110111111101110111211122121122012111111112202002111
1111111101001111111010110111110111110111111111111011111111111111111110110111101111111011011011110111111111111100110100111111111012120021212202101202122211221201
0101111111111111110111111110111011111101011100111111111110110010101111110001111111111011111111111001111111000101001111011111110111112212012000122112021001210010
0111111101111110100110001111111011101011101110111111101111010011101111111111111111100010000111010010111111111011100101111111111212112201122122210112101011110211
1110100010101011111011101111111111111001111111111011111112120212211212212221211222212101110011111111011001110111011111011111111222010000202222021110201210111111
1111110010001110111111111110101101111110101111111100111121012021220012021012211002121210111111111111110001011111101111011101111111112221122211002122221212122111
1011110011101111110101101011100001011111110010001111001112221102222201202201221010221221101101111111111101100101111110011111111112121012222212102111000122121011
1111111100111111100111101101101011101011111110011010110112022202101201120021202121100101011011111111101111111101111110110111111112110112121211221221222120110110
1111101101101011110110011110101101111111111001111111111121100212122121212120102210220210110100111111101011111111111110111111111212211122012022001122201212211211
1101110101110101111111111000111111101111111110111101011110222121110220101101020010211111111111110100101101111000111100101101011101121110120122202212120222212211
1111100001101111011111111101011010111001111111111111100120002211022021112221102112212101001111100111111101101111110111111011110211211022201110122222221002211111
1111100111101101111101111001111001111110110011010101001112112110112010221122122221110221101101111100111101101101111101111101011221221011201202102222212222201111
1111111010011011111001011111001111111001111011110101111122020112101211202120211221102110101111011110111100110010011111111111111121120200222221212022222122212200
1111111110111011111011111111101111111011110011110111111002100101211021211221201200101211111101011011001011110111111111010101111212212202200111112222222200022111
0110011110101110101100011110101111010011111111100101101022021222100111011221100211121011111110011101111111111110111111101011111222110121112122112012201122012221
0011101111111111011111111101111101001111111110111011110112210102022112200210210102012101111011011101011111111101111011010111100101111111111111102222112112121120
1111111001111111111111111001111111111011111111111111111122121220122220210200221002011211110111101100111112121020202102110202102011211212111111110122101210202121
0101110101101110011110111111101111111100111101111110011011112110202111101200222102120101111111111111011111212220211021202011110212122200011111110012122011122101
1111010111110111101111101011111110101110111101111011010111112122220101111020201210211121101111110011101111210121210100221211222122122022110111112101211112001111
1100011110111110111110011111111001111111111111111111111121212102112212220012111022222001111110111001110111102222200212222111110121221212011111011220020221101210
1111111011111010100100101111111110101111101111111011110121002120110012210002111022020210101111110110101010022012100121122112221221121121111111010001021101120211
0101112011222222012111110112022020011111101111110011111122211212002022121111220111202121101111111101111111021112122122211101111112101211111011111122100121122121
1111022202012101012002221021102121211110111111111011001101220221211021112110212101211121011011111011101011210001020121011121211121112121110101111110122122211120
1011121221221122022121122220120110201111001011111111011121202211211202022202022111112111111011111110111110101202222222111122122010201120111011012101211111122111
1101212221100212020102201001011111001001110111011110111102212121121221212120001002210211111111111110110011211102222112221011210122101010111111110120212221221221
1111101210211201122122222211111120110111001111011101111111201200001111200101122112122121111111001111111110012122120121212202201021221101000011110221011021221221
1111201221102100111112221022210221001010111111111101101120120210211210202012120222222211201212020101110012202121221210112102220001022211101101112220020221222221
1011122212222221001222110221112012101111111111111111110122211122222102222222222212202100122121220111111112112101122222000022002211220021011111111211221022211211
1011110121011212222012211211211111200111010111111011011110222122101120022222002211212222100021021100111112201221222221122110122020101121111011102111100121122101
0111221010112010022001221021110220011111111111111111111012210001202221102222200120022221021111020011010112201201220211200222111101221221011110110002100221102200
aaaaaaababbbbbbbbbaaabbababbaabbbbaaaaaaaaaaaaaaaaaaaaaaaabaabababbababbbbaabbbbbbbbabbbbbbaababaaaaaaaaaabbabaaabbbabaababbbaababaaaaaaaaaaaaaaaabbaabbaaaabbba
1101201122210221122002102221222002211101111011001111111022222202122200202222210220222122112221021111111011210112211022221201212102111111111110111112210001211010
1111101022102121022221201210101112011111001100110011111101021111122222202112212222021222102221001011111111021221210201111221202221202112111100112122011221121211
0111122210212112111212201201211112110111111101111111111122110102102210202222001202101220102011111101111111221122122110221221211102012212111110112212001202101211
0011211110010211011100222221201121010110110011111100111120022122022222022022222220122220122112121111000112112221011221211200110122112221111101012101122221122120
1111220120012011112221120011002202101100111010101011111111111100021200001102220201012002211111111111110112200010110021211022222221022222001010111220002022222121
1110202022102121201111110021102201211111111111111111000101101111101111100102211122222211121010100111111112111221101011201020212221110222111111012121212110221111
1111122221202011021021112100212110211011011111110101000111101111122011012121101211222221110020201110110112121222222221220212010000112121011111112011112200010211
1111211110112212102011200020022220211111111110110111010011011110111222122121022012101020101011200111110112010222121120121200202211210222100011011111011111101110
1011221011221122220102202010110220011111111101101011101111111111021001222111120120021111222012111111011101101001121101111102221212110122111110112122220011212121
1111022212202112221211112102201120211101110101111011111111111011012110011112222202000121110202221011111111012212112211011121112211021111110111011111101100101011
1111110212211010021122121002210221111010011111110111001011001111111211120202121000111111221201111111111111112222120102021221101001102102111111111100010111101111
1111121210100211222222212111122110211111110011111111100011101111122221122220221110121210220222211111111011011122212221221222221102222202111100111110111101111111
1111210001211212022221211002100121211110011111010111111111111111122222112222212212211122110212121011110112212222222111112122222002102021011111111001110110010111
1111222212212110212111010221122100011111111111110111111110111111121212000112221202121102120200021111111111202220200222212111221110211211111111111110111101010111
1111122202021122121221120212222112211111111111011110011110111111112102122201222200211121221001021100101111010121120220222120102110222110110011111111011111111011
aaaabbbabababbbbabbaaabbabaabaababaaaaaaaaaaaaaaaaaaaaaaaaaaaaaaaaaaabbabbbbaabbaaabaaaaaabbbbbbaaaaaaaaaabbbbbbaaabbbaaaaaababbbabaabbaaaaaaaaaaaaaaaaaaaaaaaaa
1111122102011221220201212021121111011111011110111101110011100011102211212221100120120221211202111101111110111100111111111111111111111101111010111111101111101111
1101202010101112022211221101012201111111111111110111011110111101111011112202112221111012221120221111111101111111111111101111111111111111100010111111111001001000
0011111221212122222121112212211100100111111110111111101100111111121210101121121200022021212212020000111111111101111101111101101110111111111101111111011111110110
1110210112220010122222201111011121010101111011111011110111110100011220222212211011202221112220021110110101101110111111001011101111101111111100111111111101111111
1111112211011221212012020212112122211111011111111111111111111111122211101112201111220120021111121110110111110110011010111110101111110111001111110111111101101111
1110111111101111110101011110111111101111111110010011111110111001100210121220122111201211022222110010111111011111101111110011111101101111011111011110101011111101
1111101111111111111101111110111111111111111111111111011011111101121211021211211202201112121212201111111111111110111101010101111111111101111011011111110101101101
0101101110111010111011101111111111111111011011111110011101111001110010210121111222200011211200221111111111110111111011110001011101111011101111100111010111111101
0100100110111111110110111111111011111111011111110001011110011111120222212220112211012102202111111011111111111010001011111101110111110111100110101111110111001011
1110110111111101011110111111010101110011111110111011100111101111110112222222111002211211111012211111111111111102022210122221121222202202111210111011111011101111
1101101010111110111101100111110111110111111111011001111111110111111101111111011111111101100101011101010111011122112221011112121221100211120120111100111111011110
0100111111010111110010100010111111111101110111010100101001111101111111011111101111101111110111010001111110111022211121121212111112212221211121110110001111011110
1111111111111111111111111111011110111111111111000111111101111100111101101111111110111100111111011110111001110022202220110001012120110121201110110111101111111101
0101110101111111101111111011111110111111111111101000011101111110011111111011110111111111111011111101111111101021021220001101022022110211100110111111001101111101
0111111111010111111111111111101110010111111111101111111111110100111111110101111011111011111110110010111110111022112001102212110211111000200111101101011011100011
1111110101111111011110111011101111110110111010101111110101011111111111111011010110110111111010111110111111110002112222222211210222120222022110111001111110111101
1110011111111111011011111111101111111111111000111101111111111111111111111111110100011111111111011101111110111012221220211001220212211100000121111101011111011111
0111111111111111011111111101111101111110110110111111111101111101011010101111101111111101111001111111111111111121221220201111202012112221111101101010101101111110
1101111001011011110110101111111111111110110111111111111111111111110010111101111100010110100111110111111110111000011121012101220111221122222111010111011010110111
0111011011110011100111111111011111010110011111100111111111101001110011100101110110101111001001111011101111111100112222210002110121222021021221011111011111011011
1100101011111111111111111011111111110011010111001111111101110111011111111110111111111111111111111111111011110122201011110221112112110101000010111111111111100111
1110111110011111101111101111111100110111111111111011001110111110011111111011110100110111101111110111111011000101122200201100210001222010121111111111111011111111
1111110101100011011001111111111111101100101001010111111011011111101010111101111101101010111111101010110101011111221222221222222122101110111011110111111111111111
1111110101101011111011111111111111111111111111110110110111110011110111111111110110101100001111111001110001111121111122222101110012102001210110110110101101010111
0111110111111111111011111111111110110011010110111110111111111110100111110110110111110100110010111111111011101122101121121211102220101111121020110100111110111111
aaaaaaaaaaaaaaaaaaaaaaaaaaaaaaaaaaaaaaaaaaaaaaaaaaaaaaaaaaaaaaaaaaaaaaaaaaaaaaaaaaaaaaaaaaaaaaaaaaaaaaaaaaaaaaaaaabbaababbabaabaaaaaaabaabbbbaaaaaaaaaaaaaaaaaaa
1111111111111111111111110110111111111111111111101011110110110110110111010111111101111111111111110111101111111122001211110221001210001102002111111010111011011111
1101111111111001101000111011111110111111110111101110111101111111111111101111111111111110110110001011101111111022211101200220111001200211212211001111111111100101
1101010111111101111111101011011111101111011001111101111110111001001111111111010111111111101101111111111111111122112221002020111220120111221021111111111101111111
aaaaaaaaaaaaaaaaaaaaaaaaaaaaaaaaaaaaaaaaaaaaaaaaaaaaaaaaaaaaaaaaaaaaaaaaaaaaaaaaaaaaaaaaaaaaaaaaaaaaaaaaaaaaaaaaaaabbbbbabbbaaaaabbabaaaabbaa1101101111111110111
01111010111111110000101101111111111111101111110101111001001111011111101111011111111101011101111111111111010111010221200211021210111122222102b1110011011111110101
11111100111011110111111111011111111111111111001111111100110111111110111011101111100111000110111111011110011101121221121222211200121022221122a1011110011010111111
11111100111101011101110111101101111111111011110111110111011111111111011100111110111111111110001111101111101111111111111102220222101122202211a1111101111111110101
11101111111111111010101111111111111111111111111101101111011111011111101111110111111011001111101111010111011111221222211221121212221122122221a1111111001000101100
11101111110111011011111111110111110111111110011010111111110111101111011101111011111110011111100111010111111001110101021122011121100122212220b1101111111101001101
01111101011011111111101111110110111110011110111010111001111110111110110011010111101111111111100110111111001100220100212211112121212122112201b1110011011111111100
11110110101100110111111111101101111111110110110101111110110111111111111111101110111111111110111100111110111111000200110110122122220221121102b1211112111012120221
11011100001011111100110111111011111111111111011111111111111111110111101011111101111111101101110101101111011111111110110201211021212211012101b2221221020211122111
11111010100010111111001101011111111111111111111011110111111111110111110111111111101011111011111111011011111111012222021212000201102222121121b0221111020111120111
01111100111101110111111111011110111111011111101101111111111111001011111111110111110111111110101110101111111111012212102212020021220010100120b2101201222101011021
11101011100111111011111101110011111111111100110111111111011011101011110110111111111111111111011011100111011011111101111111111111110101111012a1102222200002211101
11011111111111101111111111111111011011011111001110111100111111101100111111110111111111110111001111110101101111111111111111011101111011110110a0102022021212012020
01111111111101110111011110111111111110101101111110011111000101010111111111111011100101110110111101111001111011011111111011111110110111110101a2120222111001121111
11101110111111100111111111111111111111111110111011101111001111111111111110111010011111111111111101111111111111101110111101110110111110111111a0111112112121011111
11101001011111101101111110111110111111011110011111111011011111111011101100110001111111000111111001111111110111110101101101111111010111011011a1202222221120110221
11101110110111111111110011111010110011010101110101111011110111101111111111011101101110101100011111101111111010011110111101110111111110111112a0221022222122110120
11011111110111111111110111110110011111111001110101110101011111010111110111111011111101011111111011111111111011101111111110111011111111111112b0210221112111212111
1001001111110s110110111111111010110111111111111110101101111111111010101001111111110011111011101111110011111111111111101111010111111111111112b1221112022210212211
10111111111111100011011011011111111110001111111111110110111111111111100101111011111011110011111001110111101111101101101111011011010111110101a1111112201101102120
11111101111111111111111111111100010111111001110111111011011111111111000110111111110001111011111110111111111110111110011111111101111001111112a2212121222100121121
10111101111110011101111111110111101011101110111111110010011110111111111011111101010111010111111111111011111101110111111111100011110110111112a2201120102102122221
01001111101111111110111010111111111111111111111111111110111001111101111111111101101101101101111111101111101110111011110111011111101111110111b2202122111211222001
01110011101110111111101111111110111011011111101110011111111110111111111111111111101111111111111110111111110111101111111111011101111101111111b1020202122211220221
11111011110111111011111111100000111011110001110111111011101101011100111111011111111111111101101101111111111010111111111111111100101111111112a1220110212222112100
01111011111111111111101111111101111110101001111111111101101111010011111101000111111101000001011011010110111110111111101011100111111111111100b1111102222110122121
11111111111111101110111101110111111011011101111101111111010001000101111111111010011001010101111111101100111111111111100011111111110110111111b1122212102101212111
11111100111000111111111010011101110011011101110111111111011011111111010110111111111111111101101011111111111101000010111111111011111110001011b102122e220020100121
11111111011101111101111111011011111111111111111111001101011111001010110111111011111100111010111111111111011111111111111011011111111101111111b1120111221001221001
10111100011101111001110111111110111110111111111000011111001110011011001100111011101010110010111111101111111101011101111010110100101111011111a1000210012222200120
01110110111110110101011011101010111111111111101011111111111110111111111011110111010111101111110111100111111111111100101011011101111111110111a1110122111212211010
11111110011111111111111111111011111111111110111111010111111000111111111110111100011111111111111111001111111111101011111100111111111111111112b2220222112021111200
01111111010011111111011101011101111011111111111111011010011011111111101111111111010101100111111111011111111111101111110111111110011111111112b1021122021100222101
11101110110111111011111101111101110111011110111110111111011111111100101110111110111111110111110011111111111111110111110111010101111111101011a1022221011120010011
10111111111101101010101111001111111111110111111101111111111111111011110111111111111110111100100010011110101111111101101111110101011111011102a1211100212211111210
01110111111111111011101011101111101010110111111101111111111010001110111101110100110111011111101101111111011111111101100101110111101111001111a1011111111010111100
