-1,-1
-1,-1
95,17
58,108
137,35
135,96
84,67
134,87
33,27
39,19
11a11111011111111111110111110111110111111011110111111101110111111101111111110110100011101a0111111011100010011101101111101111101001111111111111111100111101111010
01a11011111110110101111111111111111110101011001110111111011111101111011111011111001010011a0110110110111101111010111110111111010111001011111110100001111110111001
11a11111111111110100001111011111110111011011110011111111100111111011011111011111112120122a1212120202122122211011111110111111111100101111111011111111011111100101
11a10111111101110110111111111001100111011111111111111001101111111100111110110111112011001a1212021210222212111220111111111111111111101111011111110100110101111001
10a11111101111101101111101121112111122212012121002202021101111111110011111101101011111122a2121021201210022212211111111000111110111111111101111111011111100101011
11a11111010111111001111111222210102021022011121111011200011011101110011110101110212222110a0000221111221122122201111101111101110101111111111111111010101111110010
11a11101111101101101010022110110221020220011101212121101101010010101111101001101122120022b0222210222121112110211101111111111011101110011111111101111111111111111
11a11111101111111111111121212121122020200012122111200121111110111111011111111011212122121b1220211112121112221000111111111111011111111101001111111111100111111110
11a11111111111110111111112120121011200220100120001221111111111110111010111011111122211000b2111221222112112120111111111111111111111010011110110011110101110111111
01a11011101111111110110010211112102101221212121212200121111111011111111100011011211122120b0212101111112001212120111011111011111111100111111001111110111111100101
11a10110111111101011111112211011102211100202220102222221011111011111111111100010022100220b2220212220212221111121111111111111010111011111111111111111111010101010
11a11111111111111110111022020120120100121112111011202221111110111001111011111101111011012a1210211211200100220121111110110101001111111001110111001111111111111011
01a11010111010111111111112220220221210222022201212020121010111111111011101100110220122211b0011001201202110211220111111001111111111111111111111101111001111111101
11a10111111111111011021012000222222210022010110222012021101111101111101111111011102112102b0221022210022201122101111101011110101010110110111111000111111101001111
11a01011011101101002112221111212222121212222022202112021101011110011011111110110211111121b1221102122212221101111111111101101111111111111101010001011100101010111
11a11111101111101121221122022100222222020221222102010111111011011111111110001111210122122b0200101102111101010110111111110110101111111111111111111110111111111111
01a10100111111101121212122122212221222212101211120000011111011010011001111111011021122212a1021211110121220211221010110010111001100101111111111001101111111111111
11a11111110111110121211112220102022220022111222101122111011111111011011111011111210100112a1202111022221122121221111001100111111111111101111111101100011111110111
11a11111111111110120111022012220212120110222222212201021011110111011101100111110212121020b1021221120012011221110011100011111110101111111111111011111101110110111
11a10110111111111102022221222222100121122020002222112001111110101111101111110001121102020a1011122002212210020111111111001110011111011011111111011100110110111011
11a11101110000100102112222220202222222201202222222212101111111111111111011111111120022100a2201012112012012101221101111001121100010202121110021021122202021111011
10a11111111110001111120122212210221222010222010222111210101011110111111100111101110120021a2201020220202211211121111111111022110101020222212022111212111101111111
01a01010111111011010222222202120022222022120101222212000111001101111010111111111201022202b2011102111201221112110100111111110212002210112210221211002112010111111
10a11110111101111122202122221022222211000221011222002011100111100111111101111110201120210b0222002101201220220120110111101112102210011122122021122012111111101111
01a10001111110110110222112210222021021222212221120112011011010110101111111111001210221222a2212121120201121111121111001111120210211011220122121212212012121111101
10a01100111111010122220110122022212222221222022210100221111111111011111011011101201111210b1020221201210011210121100101001021101222112111222022111022020121011101
11a11101111111001121110122222200122101222212200222121221110111101110101111111111121111111a2111121221022022111111111111010112121221122122121212010121122221111101
11a11110111111101121201212012200212222202222201221221100010111111101111111110111212101112b1201101212202101111211110011111111222220201121111202202120012011001011
00a10001111110011121111122220010212100212201120000121010011111110111011111111011111211010a0211112212020102100221110101101011112112101110202120120121222001111110
11a11110111001111102202221201121212012122102020102122221111011010111010111110111020201220b1221201201211211112021111101100122212100111122222202211211021111111101
10a11111111111111102021002022220220021211110220002100001111111011111111100111111120012112a2211022221120211101211111111101002012011011012202021121121211001111111
11a01111111111111102221020000122102022211212221022120011011110111001001101111111120111222b2200221200211112211020101111111022112111211210222012102021212210101111
00a11111111111110122122212220122102222202120220102111211111001100011101110110011012110210b0112101210102120111121100101111121212001111120110212102211122211010101
10a01001001011011111011122220102002022212102200222021101011111111101111111111101111111101a1111111111111101100111111011011012102220001121122011221220020011101110
11a11001110011111100112112121212122121112122222110111101111011011101011111111010111101100a1111100101011111111111111101111122212222200220201122102212111121111111
11a01111101111011121222022112211222210012211021211111110111110110101111111111101101101111a0111111011111101101111111111111122001021222122201212111101102120011111
11a11101101101001101222112012122222222211112112121111011110001101110101111111011011111010a1110101101100111111101111110111100101212211012220112112011120110010110
11a11101011111101000012221122022010200012221111221111111111101101011011111111111011110111a1011011110011111111101111111111111202122112220112001022211120221111111
11a11111111100111112112102221122221222202202222111011100101111110110111111111111001111111a1111111111111111011101011000111022221222201020002112111100222001011101
11a11110111111101110100121111222011221201111121121011110111011110011110011111111111010111aaaaaaaaaaaaaaaaaaaaaaaaaaaaaaaaabbbbabbbbabbaababbbbaabaaaababaaaaaaaa
11a1011111011111012111110202002112020212211212112111011011100011001101111110110110111111111011110100010111101111110011110021111011210100221200201112022021110110
11a1111111111101011100002221212201111111112201112100110111101011101111111110111011011110101111101111101111111111111010111011011021020220212211102201122111011111
11a1011111001111111022212112221122120012221211202111011011111111111111011111111111110011001101100111111101111011100111110120122221121201001111120212112200111110
10a1111111001111111111101110111011110111111111111111111011101111111111111101011110111111111101111110111111111111001100101112112211121221122010221121120011011101
11a1011110111110010110111110111111110011110011111011111111111111111110011101110010111011111011011100110110011111111111111112120211222221121000121110020121110111
11a1101111111111110110011111101100111111111111111111110111101111000110111111110111111110011101110111111111111101111111110122211102111111012012012200111010111111
01a0111111101101101111111110101111001111110111111101101111111111111101111111111110110111101111111111101110111001111111101101210211111112022212201110021111000111
11a1111101101011111101111111110111111110110110101011110101100111011111101111111110111001100111101111110111111111101111111111212222112221120021012022202111111111
10a1011111110111011111100111011101110111011111111111111111101111111111110111111110100010001111101110111111110001101011101122222222122010121022121020011121111111
11a1111111111111111100011111111111011110111101111011011010111111111111010111110111110011111110111111111110101110111111101111022202122111201121102102222011001111
01a0111101111110111111110011110111011111011111111111101111101111011111111011111111111110111101011110011111010111111111111002102212122111202221020222002211101111
11a1111111010001111100111111111111010100111111110111111111111110011001101010011101100111111111110111111111010111011111111111111111111011011110110100111111111001
11a0101011101011111111111110101111001011011011111111110111101101111110110200111202211100202101011201111111001111111110110110101110111110101111111110111011111110
11a1101100011101110111111111111111101111010101111111111111110111110111112211121022211212122111121022010111111101111111110111101111110111111111111101111111111111
10a1111111101101111011111110111110101101111101111111111100110111111112211221211221011122112211112012111111111111111110001000111101111110101110100111111111111000
11a1111111111110110011011101111011110011111011110100011011011111010102122120212012101111111221221021101111010111111111011110111100101111111111110111111110000011
11a1011000111111110011110011111101011100110011001100111111101101110100100012111011101202022122110112111111111011101110111001111111001101011111101111111100011101
11a1110101110010101111110010111111111011101011111101111111110111001011010221112100222022111221210201111010111110111111110111011111111111111111011111111100010111
11a1110111111110110101011111111100111111111111010110111101110100011010011212121210012001002111110121110111111111111111011011011111111111111111101111110111111111
01aaaaaaaaaaaaaaaaaaaaaaaaaaaaaaaaaaaaaaaaaaaaaaaaaaaaaaaaaaaaaaaaaaabbbabbaaabbbaabbbbaaaabaabbaabbaaa111111111110111111011110011011111111111100111111111111111
011011111100111111111111110111111111011101001111101111110111110111001222212121021110122021112012202011a110110110111101111011111011111110111101111001010111111111
101110001001111111101111110101100111101010001101010111111111111100110121120112100221202220201212022110a100101101101101111001111111001111011111111111011111101110
111111111111111100111111010010111111111100010100111111011111111111110222111222110112121110212021201211a100110100111111110110110111011111111111111010111111101111
101111001110110110101011110101111111001010111101111111111101101111111112222112100112202122212211110111a011011111101111101101011111111101111111101011111111110111
111100101110011111110110110111011111101111111100111101111011111101111111111122221121211111212210110111a101101001111111100110111010110101111011111111111011110101
aaaaaaaaaaaaaaaaaaaaaaaaaaaaaaaaaaaaaaaaaaaaaaaaaaaaaaaaaaaaaaaaaaaaaabaaaaabbbaa120222001220111120211a111100111111011111110001111010101010011010011110110111101
11011101100001111001110111011010111111010111101111011110111011001011112211012210a212200110221212122201a111111111011101110111111111111011011100111110111111111001
11111111011110010111111001111111111011111101111111101111111011111001112021212111a101112112101210121010a101011111011111111011101111101111111111111100111111111110
10101111111110011101110011111111110100011111011110101111100111111001001201211212a210221111022102110211a101111011110111111010111001110110110100111011111011111011
11100101011110111111111011111110010111110111101101001111111111011111022121102000b211111121112222200101a111111111110111111100110111100111111011111010110001110111
11011111111111011101111111111111011111111111111100101110111101111011120202212202a211222110112202112101a110111110110110111110011111101110011111111101111111111001
10101110111111011111111111111111001001110110101100111110011111111100110201001210b212011211222121111210a101111111110110101111100111111101011011101101110110111111
11101111111111111010111111011111101101111111111100111111111110111111111002210220b121211020222120111111a011111111111001010221011120210111211100002212011011111111
10111110111111111110101111101100111111011111011111110110111100010111121000012222b022111221102210121011a011101111100110112010101120120212101110222121121111111111
11111111101110101001111111111111011110111111111111110111101111111100101221221112a211210200122221112111a111011101111011121111122221211222112212101010211101111101
aaaaaaaaaaaaaaaaaaaaaaaaaaaaaaaaaaaaaaaaaaaaaaaaaaaaaaaaaaaa01111110011202112220b100100121201022212101a111111111111101122112211121101121112200212212101111111111
01110010011111110110111101011111101111111111111111111111101a11111100122111122211b122102120001122001111a110110110111011121222112100211212102212122002121110111111
11011101111010011111101110001001110110111111101111001111111a11101100012102220121b111012022212102212111a110111100101111111112010222112110121121212202121111101111
10010110101101110111011111111101101111101111110111111111111a11111010111202101202a022002212122212121001a111101110111111101011212122212111010212112120001101011111
11010000111011001101111011110101110011110111110111111111111a10011100110010210221b211201121020021101111aaaaaaaaaaaaaaaaabbab2011220221222211011112212111011111011
11110101110011111111111011111110111111101010100111111111111a11111100021221211221a21212010220002212101111101110111011111122a0110002210222102122102211221111011111
10101101111110111111100110011110011111111111111110111011111a11111011121212200210a12122100221100210010111101111011111111220b2002201200222022102020222221101101111
11111110111111111110110111011111111110111111111011000101111a11110111111202201202a21011112112112110211010111111011111011222b2001222212112220202220121222001100111
11011101101111100100101001110101111111111111110011011011111a11111110111111111011a11111110110111111111110011110011111101222b2211021022202220122200122022110101111
11111001011101111111110111011111101111111101110010111111111a11111101111111110111a01111110101110011111001101111111101000101a0222022220220210012212212122101001111
11111111011111101011010101101111110011111101111001110001111a10100011010101110011a11111101111011111001101111111101111111110b2222221122222222002222121202111010111
11110111011011101101111100110111110111111111111111111111001a11111101100100111111a11011111011100111111111111111111010111101b2200021220202022222122211120011111110
11111100011111111110011011101111110111101111111110110110101a11111111111111111111a11011111011111011110110111111111110101122b2012111202122222122222220220111110111
01111111110100100101111111111011111111111001111111011111110a00111110111111010111a11111111101111111110101110111111110111101b0212200211211022220120212202111100111
01101100111111101111111101011011010111101011111111111111111a11111111111111111111a11111001111101011111011111011111111110101b1222112222222022122222221021110001110
11011110111011101111110111101101100111111110111111010111100a11010011110111111111a10001011111111111100111101101111101111120b2021021221122120211221222201001110110
11101011111111100110111111101100111111111111111101111110111a11111010111111111011a01111111011111110011111111110110101111112b0200222102122121021220212022111111110
11110001111111111001111111111111111111111111111111011111101a00110111101111110100a11111111000111111011011111010101101011121a0000222210002120021022001110011111101
11110001111100110111111011010111111100001110022012121222202b20202122201110101111a00110011111111111111101111101110110001112b2222200202222021211221220221111111101
11111110011111001010101111110111110111101111211102112011111b01010210001112111110a01111111110011111111111111111111111111102a1212222222222222220102200022011110001
11111111111111111111111011101111111101111110112120010210110a21120211111211111101a11111111010111011110100111101111111100200b1202020200122020222112112201111010111
01101111111101111110010111110101111110110112120100122011121b12122121110222111011a01111101111111111101110101110111111111102b2202202220122121022221221222101110100
10111110111111111111011110111011011111111012121212021202001a21121022001001101101a11111011110110101110111011101010111111220a2012111221222022202220012122111111111
01111111111110111111010101011101111111111112012111021221121b12101020101012101010a11111010010111101110111101110111010111102b2221202222212212122120222211010111111
10110111111111100111101101101111011011010112022222101111212b01021112212012111111a11111111010111111110111111111111110111212b2220220000222222221212222122010001111
00111001011111101110111110110101111101001112222221210122212b21111000211221111010a11011111110111001110010111101111011011120b1202201122202221122220122121001111111
10010111111111101111110110111100110001111002211121201111112b21022022211222001111a10110010100111110111110111110101111011022b1202202222222221222022221222111101111
11111111011111111110001110110111001101111101021102222111122a20220101111222101110a11111101101011111011011101111011111111012b2210212222022022012122222222111111100
11010110111011011111111101110110101110111102120111210101120b11212220121100111111a11111110101101111011101111111111110011122a2112222121110120110120110221010111111
11111101111111111101111011111111111011101112211211201111110a10221021122221111110a10110110111111101111110101111011110111021b1212011112120020010122012122110111111
10111100111110101101011100011111101111111102121021221112012a12121212221022011011a10111111100111111111111111111111011111122b1222011200211212211122111111111111111
10101111111111111101111110111111111111110111210202022120201a22012110221002111110a00110010101111011111111111011111111111112b0122112201120221011001101201101111001
01110110111111111110111111101111111111101111212100121120120a11220212212211110111a11111111111101101110101111110101111110120a2221222122022110122201012001101111111
10101111111111111101111010111111110111111102222112212121001b11201002220122111111a11111111011111111010011111111011111101120a0120211212102112121212211102111111111
11011010111001111111110111101111110100111111110221222122102a01201112102122111111a01111111111111101111110111111011111101122b2202111202221010111102122212111111111
00111111111101011101111111111111010011011112210010120202101a02110101122112111111a01111111111111111111011001111101001111000b2210111000221121100001221100111111100
10011110001111110111101011111100111101101111111202111221222b02212210222201111111a11111111111111011110111001111111100011021a2020122221011212210102122212110111101
11110111111001111110110011111111101110111111220222222211100b11111021110002111111a10111001111110110011011101111101111100110a1011110011111111011111111010111111011
11111111111011000111111111110101111111110110112221121200012b20211122112110111010a11111110110111111111111101101110111111100a0111101011110111111110111011111111111
11110110111100111111111010111111101111101112201011102222101a22210202122021111011a11111100110111011111111111111111110111101a1111011111111111111011111101111111111
11111111111111110011110111110111110111111010022121201212201b10021200210011100111a11111010110010110111101101010111111111101a1111111111110111101110100111111110101
11110011111111111001111110111011001111101110221000212121101b21211122001212111111a01011111110111011101111111101111110110010a0111111011111111111101111111111101111
00011111101110111111101100111111011011110102221122111122200b11112101112021101111a10101011111001011111111111111110110011100a1111101111111111110111111100111100110
10111111111101111111111111111110111011111112111011222210001a02012111221120110101a11100111110111101110011111011111111101111a1111111111011011111111111011110111001
11011111011011011110111111111111111111110011010111111101101a11101110010111111111a11110100111111110011101111111011101100111a1110111101011111001111111111111111101
