-1,-1
-1,-1
85,108
27,81
134,5
151,85
129,94
71,13
97,45
39,68
01a0111111010010011111110111111111101101101111101111011111022010202112101212220121220100111111010110110101111100110111111221110212221211221101222021111111101110
11a0111111100110111011110111100011101110100101100011111011122202112011110111112211121120111111111010111010111110110110120022222222212122201201212120121110111111
10a1111111111111101111101110111111111001111111111111011112011022012010121201212021212110001111111110111101100111111011102010210002211212210122221200111101111111
01a1111111101111010110011101101111110111111111111100111102011211001221110101220222221101111010111100110010111111010111121221010222121201221021022011221110011100
00a1110111010110111111011111111101111101111001010111101112211001122122110112202212212101111110111111111101111111111101112221120211121122222202222101221111111011
11a1110100011011101111110111110001011110010000111111101121211201202000200210202211220021111111110111010110111111011111000122110021020222111002112222201110010111
01a1011101111111111111111111111001111111111111011111111011212020222112202000010222221211111111111111101111101111111111102210201211020222212202022100101101011111
11a1111110111101001011111011111011010111111111110011111111112121222121112021210220222201111111111111101110111111111111111022222112210001011211211102211110111111
11a1111101111111110111111011011111111111111001101011011120012101222220211121222111121111111000011110111111111111111111122020121121112211222021210201100011111001
01a1101111101011111110111111110111110000111000111111111102202111211122211012201012210221111111111101111111010111111111100120201212122220222012111111021111111110
10a1111100101110111111111111111100111110111101110111111021212111112102111000111222222121111110101001011100111111111010101212210112122020210212110101200001011110
11a1011111111111100111111111111110011111111110101111011112211101021220022222212212012011011110111111111110111101111111002211002211212101111111022200220001111111
11a1011101011110111111110111101111111111111111111011110021200011122100111111121201211120010011101111111111111011111110121121011211221202112222211110111101111110
10a1111111101111011111111111111110011111110111111111110101102210022012222120210111001011101111111101110110111111111011020011112111211211102111020212111111000101
11a0111101111010111111110111100110111100110110111011011122211002001202010101121120201201111011101011100111111111011111100112121212101221222120200222100110111011
10a1011111011000101110111101111111010101110111011101111102002102101122202210202221022201110111111110110111110011111111112102101122112011120112101202101110111101
11a1011111101101111001101111011111110111011110101111110012202112102212220220222222121211111101010111111111001001011000110012222110201212120122220111121111111111
01a1111111011111101111101111111110101111011111011111110121011220102201200210112122120111110111111011101111100111111110102121221101110111112011111110111101111010
11a1110111100011110111110111110101111111111111111110111102001010022222220220211222122111101111100111111011110111110110112101211201111212121212012222111111110111
11a0011111111011100111111100111111110011100101111111010012110010102211012022222222222110110000111001011111011111010011112012121212121110221022111122211111111011
11a1111100111111111101111111111011111111111111111010111122122102220111220211101101102011011111111111011110111111111011110122112220111112102121101022220110110110
00a1111000100110111110001001111111111101111110111011011101200110020000201121200202112121111111110111111101001110110101111111111101111111111111011101111100111011
11a0110101100111011000011010111011111010110111011111111110210012011122222212201212110111011111111011101111110111101111111111101101110111111111111011111111110110
11a1011011011011011111101111111001101111111111111111101111000201112022121122221112122221101111011111110111111001100110110111100011001111011111111101111011111101
11a1111101111001011100111011111011111101111111111111101101220001111100001212202012221210111110011101111110100111111111111111111111111111110010111111101111110111
11a0111101111010111111101111111101101011111111100011111110000212021000222022212212012200001111101111111111110100111101011101001111010110110101111111111011110111
10a1111110111110001111111111111111111100111111111101111102212221212120111022112121121101111111111111111111100111111100011111101011011011101110111001111111111111
01a1111011100101111111101111110100111011001011011110101102212212222221012210101121011221111111111111101110001111111100011110100111110011011111101111110101111100
01a1111101111111111111011110011011111101111111111101111122211212212112110212020002222111111111111101011011110111101011011101100011111111011101001001111111110111
01a0000111111110111111111111101010111111111101001010111111101111111011111111111111111110101101111101111111111111111111011111100111111110101111110101111110110111
10a1011110010110111111101101101010110100111111111100101011111110101011111101111111000020212221112222012201110122011111101111110111111110111111111110111111111110
11a1110111111011110010111010111111111011111111110101111111111110111111111101011111111121202211110212021211221222211011011101111110110111111111111001110111111111
11a1101111011011110111111111110111111011111110011110101100111111110111101101111111222212020102120020011122121112101111111111111111000111110011111111111101110110
10a1101111111111110011101111111111111011111111110100101001111010011001110101111001112201102211011101012210111111210011101111111010111110101111011101111111111111
11a1101101111111111111010111010111100011111101010111011111101111101111010101001111121101120021211021022222210011210011011111111100111101110011111101101101110111
10a1010111111111101101101011110111111111110111111111011111011010100111111111011111111122202012112222222010002100111011100111101101101001111010001110111111110111
11a1111111111011101101101110111111101111101111111101000101011110111110111011101111110012111200222112211020221121211100011111011111100101111011111101101110101100
10a1111101110101001111101111111111011100011111101010001111101101111011011011111110220122020221022102122112211012111011111110111101110111111011111111100111001101
11a1101111111111011111111111111111111111111111111101111101111011111111111101111111012122122120212022112111010201101111101111111101111111101111110111101111011000
11a1111110111111111111111011111111111101111111000101101111101100110011111100110100222122211002211011221202111212210011011101011111111111111110111101001111101111
10aaaaaaaaaaaaaaaaaaaaaaaaaaaaaaaaaaaaaaaaaaaaaaaaaaaaaaaaaaaaaaaaaaaaaaaaaaaaaaaabaaabbaaabbbaaabaababaabbaabaaaaaaaaaaaaaaaaaaaaaaaaaaaaaaaaa10101011101111111
0111011011111111111111101110111111111010111010101110111000001011111111101111111111210022100122221201211121110211111111111010111001111101011111a10111111111111111
1110011111110101111111111110011011111101101110101111111111011111111110011111110000212111212220211211112210211012011010111111110111111111001111a11110110101110111
1101111100101111010111101111000111110011010111111111111111111011111111110111111000110011101112011111122122022221011111111111111111111111011111a11110111110111101
1110011110011111011111110011001011110111110111110101010001101111011011111111101011002121011220222121110110011211211111101111111111111011110111a01111001111011111
1101110111000111110001111100111100111111101111100011111110111101011111111111110100122020222222211121201220002011000101111001111101111111010101a11110111111110110
1101101010111110110111111111111101011010111111111111111111111110011111000100101011221222212010112221211211101222011111111111101111111101100110a11110111111111111
1111111101111001110110011101111111011011010101010101111111111001110111111111101101102000110222212211112201202121211111111110100100110000001011a10111101111111110
1100111101111111111111111111110011101101111111011111111101111111111101111100111101212111122020211122221221122220011110101011111111110111011101a00111111001111111
1111111101111110011110111110110111110111111011110011111111111111011101110101111101200021112221211212222100112212211111110111111111111111111110a01111011110111110
aaaaaaaaaaaaaaaaaaaaaaaaaaaaaaaaaaaaaaaaaaaaaaaaaaaaaaaaaaaaaaaaaaaaaaaaaaaaaaaa00102011222211112111011212210122211111111110111111111111111111a11111101111011111
1011011111111111100111111111111111011101100111111111111111011111101111111011111a11121112101002121210222112200210101100011111110111111111010110a11011111011111111
0101101110111101111100010110111101100011111111111111011001111111101111111001101a11000020112221201221111220112122011111111111111111011101011111a11101111111110110
1110111101001111111111111210122210010011201221122011021111111101111011111111111a11111212211212010120010122112020101110111111111111111111010111a11111110111111111
1111111111111111111111111000021110202102102220221101220110111101111001111101110a10222120211111122221212222121211011111011111101001011101110111a11111111111010111
0111101111001101100101111102121110211010011110012101220111111111111011111111101a00001012101021221102112210222012010111101111101111010011010111a11110101111111011
1111001111111011111110102000210212121202222012122202222111011111111110111100111a11011021022011112202011022122211111101110111110111111101111110a01011111111111011
0111111101011110110111112202001002121120120102222122111100110011111011110111111a11111222212011002221211112011121011110111101111110110111111101a11010011111111101
1111101111111111111011011022222112021202222111012212102111001010111011110111001a11020121111100022201121122121200201010111111110101010111111111a11010111010111111
1101011011111110110111112122101221101022210022120021122101011111100101111110011a01012102122112022021121101021020011011100111111111101111011111a11111111110101011
1111111110100111111011111021200210011211220100010110022000111110111101111110001a00022201222201202221121112001011200111111111111111110011111010a11101101111111111
0100111111111111111010112210222222222122021102211212111101111101111111110111111a10101011011111110110011111111111111010110110111001001111111001a11111011101110111
1111111101111111111100012120222212111122012202101112021001111110111101011111111a11011011111111011011111111110111100011111111111111111001110101a11111011111011111
1111111111101111111011110020211211121012221110111212102111111011111111111111111a10111111001111010101101101010110111111111110110011111111111111a11111111011001111
1111011001111110011111112112220111020012222121012021210111111111110101101111010a11110111011110001110101111111001001111110101101101011011111101a11111111111011111
1111111111101111011101111101111121212110020120210211022111111111111101011111010a01111111111111101111111100011101111110111111011011110111111111a11111101100001111
1111111111112212221221022221022212112201212211220211220010011101110111111011111a11111111111010110101101111011010111111111110111110100011111101a11101111010111111
1111111111001212012001110022122211221220212001001101210011111111011111111110110a10111100101111101111010111011110101110011010111011111111111111a11110101111001011
1110111111111012211102010202222222220220201120112201102011011111010111111011111a01111111011011111111111111111110111011100100110001111111111111a11110111111111111
1011101111101210021220112212121012220111202222202210121111110111010111111111011a10010111101010111111100011110011111011111111010111111111101011a11111000111111111
1111111111112121202112210222222022201022010022122021212000001101001111010111111a11111100101101110011101111111100111011111111001001111111111112b02112211021221021
0101111100112220211222002222212202220222220112020122211010111111111111011111111a10110111001111111111111010111101111111111110111011111111021120b21010121020111111
1111011110001212122012211200212220020222022102121100112110110110111101111111111a00111111010110110101110111111011101011111111111001111101111020a11122210020201221
1111111111012110111112222222120002200222222022111211211101001010101011111111111a10111101111011111111110010111111111101111111011111101010102021b11212102102112201
0111010101112111121100112111210022121122011211112220020101111100110111001111101a01111111011001011101011111111111111111111010011111110111121220b10122011211212101
0111011111112121010122111122012121202022202200220112112011110111100111110001001a11101111111111111101011111110011010111101101111111010101010121b21222010002222110
1111111111110211101121012221020222000200112212010222122011111111111110111011011a11011110111111110110111111101101111111011000110110110111000012a21211201012122011
aaaaaaaaaaaabaaabbbaa1112210222220112122212201202221022110111110110100111001101a11011100111110110111011111011011111011111111111011011111012200a01122200100212011
11111110111112212211a2120222222012211212222112211110101011011110111111111111111a11011111111001101001011110101001111110000111111111111110221211b21211210012222111
00111101101100002221b2011222222222122011212112101121121101100110001100010011011a1111101111110011111111110111101100111210aaaaababbaaabaaabbaab2b20121122220012110
11011101111120202111a1112001202102210002202101022212121011110110111101110101010a0100110110111110111111111111111101101121a2201212200200112220b2b22122201211102211
11101110111021112211a1012022012222002221222102222222120111110110101110011111001a0010111110111111111010001111111101101211a2210102210122122222b2a02122100221120121
11111111101111112210b2102212222220102220202111012221120111011000011111100111110a1111011111111001111111011011111101122002a2120211002222100002b2a02012112111110021
11101001010112222101b2212220200222120222121120121102212101111010011110101111101a1011111111101111110001011111111111011211a2112212022102222222a2b21110102200122220
11101101111112101111a1221100100212220121201110111111010001111111111101111111111a0011101111111011100111011111011111211021b1121121021002120012b0a02212202222111211
11111011111111222220a1101221021011210211012101111111011111111101110101111111000a0011111111111111001011101110111011221111b0020022110011221202b2a21211121021121021
11100111111122212101a2002211222200012020222111101101111101100001011111111111111a0101101101111011110111111110101111220011a1222021012112022220b2b21112102221101211
11111111111121211221a0011120222011210212222011101011011110110111111111010111101a1011101101111111100110001110000111210200a1202210221001111221b2a22212122102011201
11111111111121102221b2121020021202122002120111001111110011011110110100101111101a0111100111111111101000111010011110102022a0201212111110022012a1a22202102222020020
11111011110112120111a0201101212122100101122101011111110111011001111111110111111a1111001011111111100101111011111101211202b2201122212211112122a1b12212112211210211
11111110001122211222b2212220220202220212121111111111011101111111111111111111101a1110101111111110111111111111111110200121a1222102122222111021a2b00120011010111211
01111110111111112121a2020211222020221211120100011111111111111111111101101101111a1111111110101111101011111011111111212211b2201211221120200211b1b02122121022210121
11111111111102121101b0021211210220012212200111111111111110011001111001110111111a1101111111101110111101111011110011122111a1012220212121010212b2a21200201112012221
11111011110100212202b1112011000210121022122111111111111111110111110111100111102a2200120200122202001121010011111111012101b2120221222012122022b2b01222001221122111
11101011111112111122b2102022211111201110010111111011111010111111110101221122011a1001100222112111010221011111111111212020b2122112221000200201b0b12011221022210101
10011111101012211001b2211110220121212211112011001111111111111001111101102000221b2101112012222220102111011111111111011222a0122011202111111201b2a20102122200122211
11011011110121121100a0112102222220222202121011111111111111111011111101202012212a2202121022222122211000101111011111121212b0101120121122210212a0a22111211202112121
11011111011001011111a1101111100111011111011101111110110111111111011101111222222b0120222002121021112201111110111110220121a1222202222112111210b1b12222101011211111
00111110101111111111a1111110111111111110111110111111111011110101010111212121122b0121111210202211212220111111011101210112a1112222211121012112a2b21111202101120111
11011101011111101100a0111111010110101111000111111111011101111111111100102111202a2101202121012122121021110110111110212121a0110122221111111022b2b22111120110212210
10011011111011110011a1111111111110010110100100111010111101101111100111111122022a2200211202202101010221101001110111111202a1201101222012222220b2b02001201102221211
01111011111111101011a1111110111011010111010111111111011110111110011011121212212b2211122121222111211221111111111011122111b1212221212201122211b0b01101101100111111
01111111101101111000a1101111111111111101111101111110111111111111110111021222211a2211022222121002110210101111001101121201a1121201212211112212b1a11111111100001111
11111101110101011110a0000111111111111111111011110111011101111111111111212100201a1102111012121120210201111011011111110100a2221222212222020200b1a11111111111111101
11011101111111111101a1111110111101100100111110110000111101111111110101112112222a2011112222222211121220001111111111201022b1220120121201210001a1a22011011111111010
00111101111011111111a1101111101011111011111111011110110101110110111111102111121b1110211011221121122111111011111011111220b1102120222112021002b2b21111111110111111
11001111011101111111a1101111011010110101111111111111111111111111010111122200110b2112121212020222021121111111101111120011b2202122121010122220a2a11001110101111101
01111111011011100111a0101111111111111101111111111101111011111011011111211121212b2212021120222112120111011111011111111221a0121220112221122200a2b21111110111111001
11111011111101111111a1011011111111111111111011111111111001011111011111110012122a1121122100122111112021001111111111210121a2122112111021121012a1b22010101110111111
11111101101110101001a1101111110110001111110110111111111111101110011111222011221a2121221122102011121221111111111011022002a1210100212221201210a1b20111011001101111
11101011111101111111a1011111111111111111001111001111111011111111111011022102111b1102012122221122022121110111011111010111a1111111111100111101a1a10111110110101101
01110111111111010111a1101101101111011101101101001111111111110111101111121120111a1102111112202201122121110111101011111111a0101101101111101110a1a01011111101111100
10101110111111111101a1111111111111111100110011111111100011100111111111001222221a0122120012102122201101111101101110001111a1101111001001011111a1a01101111111110110
10011110111011001001a1111111111110101111111111111111111111110111111111111101101a1022202220111121121211101001111111111111a1110111110111111010a1a11111011110111111
01111011111111010111a1111101111111111111111101111111100111011111111111211221012a2221222122012121001021111111111111011111a1111111101111111111a1a11101111111110111
11101110111011111111a1111110111011111110001010110001111101110111111111212111201a2111022201022221111211011011111101111111a0111111111101111111a0a01111011111111101
00111111101111111101a0111111011111111111101111101111010110111101111111112110111a1102010110222211221021110111110110111011a1101111101101010111a1a11110111111010011
11100111010101101110aaaaaaaaaaaaaaaaaaaaaaaaaaaaaaaaaaaaaaaaa111111111022211222b0200120211211211101010101011111010101111a0101111111111111110a1a00111101111111101
011101111001111001101101010111011111111110111110111110111010a111101101111100222a2211212210022022110210111111111110111011a1111110100111011111a1a01001110110110111
111111111111001011111111110111111111101101101110011111110111a111101011111110110a1100111111001101101100101111111111111100a1110111011101101111a1a11100111111110111
