-1,-1
-1,-1
50,71
110,24
149,49
116,68
87,58
51,21
101,22
111,10
011110111011111110111110011111101100101111100111111001111111111100011010111111101010001111101111002001b101211201111111010020122111110111100111111111110110111110
111111011110111110111010111011111111110110110111111011111111111111111111111101011111110111111111211000b112201210101101211100112111011111111111110010011111111100
111111111111110110111111101111110111011110111110101111111100110110011111111111111111111111111110101222a201112122022011022200120111111111111101110111111111111111
110111101111111100111111101111110011011110111111011110110111111111111111011110111101111111111111011121a121121022221012122012012110111101111111101111110110110111
111110110111011111010111111111111011111111111111110111111111100111111101110111111010110011110111102121a101121102022022000221001111011111111001011111111110111110
111111111110011000110111111011011011110110000111111101100011111111110110111011111111111100111111221112a021000011001202011110211111111101111101110111111101111110
111011111111011111110101101111111010211200121210211111212221112111010111101011011111111011111011222021b120120121210101210111212111001111111011111111111100010101
000111111011011110011111111110111111120012220222120221101210121021101111110011101011102121210221102222b212021022122220102220122111110001111011111010111010111101
110111111111111011111110111111111110201212121112112202122112201221001101111011111111110020210022211010a022220001002022210122112010111011110011111111101011111101
111110011111111111111110101101010011120212200212010002120111211201111011111111111110110221100202212222b210222001222122222221002111111111111011111111111110110001
010111111010110111111111101101011111211102122111111202211221101111201111011111101010102121121100222222b020222220200020221120000111101111111111111111100111110101
111111011110111111011111111110111111001022001221011221110121210111111111111000110101100211220110011021b220022022222222222022210110110001011010111111111111111111
011011111101110110011111111111111111120112011211021021021020220102210111011011111011102002122200121222b022020220212222012220022011110110111111101111111111111111
011101110111101111011110111111010111211111120211121202011221212121110011101111110101111011011220120022b221202202222222222022222111111111111111111011111111110111
011111111111101101101101101001011111111211122211202111212222122012100001110011101111112012210202222222b021122202122022222000122111011111010111100111011101101101
110011111011110001111111001111011011011110112121022221121221222212010101111111111111101012112122212201b022220102202201002222122111011101101111101101110111110010
111100110111110111101101101111011111020021122122121111211221110221201111111101101111001110221122222222b222220220202201120110201111111101111001111111101111111111
011101111110111101111111111101111111022002111111102022010012112222111111111111011101102222211112022100b221212200222202222202122101101111111111110011011011111110
011110111111111101111100011111110111220210212112122112112122201211200011100110001101111002220022202220a102222200022122201200020111000001011101011110110101110111
011101111101011111111111111101110000121001111122121021021202111211110110111111111111111220211110202012b222102222020212022221221011101111011100010111111111111111
111100101101111111101111101110011011201012102210201022222211111220101001111100010111111121020222202212b022122202121102222120202111110011011011011011111011111101
101111111110111111111111101110110110202112012112010112122112222122110111111111110101002121220111022220b220212222202221112222122101111011110111011111011111011101
111111110111111111101110111101111111220012100211101211212102012212111111110110110011101221122220222220b202222202112001202221020111011101111111111011001111111111
101111111111111110111110101011011111211201111221021021111212122222211111101101111011102111112221202212b022221222222022201200201111111111111101010111111110111111
111101111101111110111110101111111111121212212221020122211212021212211110111101110001012122011102221222b222212202002222220112021101111100011001111111101111111111
001110111111111011111110111111110110012202021112222122210220121121211010110111111111111202121112202220b202222220020222022112121111001111111111111111111111111111
111100011111110110111100111100101111221001122011012210122012110012111110111010110111100001220220002221b222022122112221112000001110101010111111111110111110101111
111110110001111110011101001101111101121021012021121101212200120021111111111111111111111111001012222210b20212212022201220aaabbbaaaaaaaaaaaaaaaaaaaaaaaaaaaaaaaaaa
111011110111111101111111111110111011020121201122012101202022101112111111011111011100112020102210121222b12202122212122012b200121111111110010101111101111111111011
111111011111111111101111111111111111212122102021112110122221211222111111011111001011110222012112222112b22200022121222102b111211110111111111111011111011111011110
111110101101111111111111101110001110111111111110210112112022212220101111110101111111100201112110222210a02022212122221100a210110011101110101111111111111111111111
111111101011101111111110111011011111222111100222121122122012212102101111111111011111111220111112222202b02220212022022020a110211101111111111110111111111111001001
111011111111011111011010110110111010122201121110222112102112112121101111111111110010102221010212222220a20012202212202220b021110111111111101011101111111111111111
101111110111011111111111101011101111112012100222111122021212121202111110101110101101112202010011222212b10112010022102121b211110101001110111111001111011010111111
101111101001111111111111011111111111111121121111020210211010121211211111011110011101112111212112112222b02202122222021000a110101111001120202211112002211120221211
111110110111111011111101010111101110221122212211112212001220001121211011111011101111000110111122200221a12122122222202101b210200011111002011212112220122122220201
111110111000011110011011011111111011102121111222022210022212121212001111000110011110112012012112222022b21121122210220012a222211111111121110210012222210112021201
100101001111111000110011111101111101011011101100010111111111111100111111011111101101111112021122022111b22121120002002211a110121101111121201021101222012110120200
111011111111100111001111010111110111111011111000101010011111101111011111111011011111111111010012120122a01211211211211120a212011111111112201022122211120221122211
111100110111111111101101111001111110111111011101111011111111111111110111011011111111110111001112012222b22002211121022102b221110110001101101211120020122000120021
101111011111011011101111111111111001111110111010111011010110101111001011111111010111100110010111001101a11010111011111110a011011110110111101112200201210211202110
111111110101011011111111100101110110100110101111110111011111111110101101111111111101010111101101111111a11101011110111011a101010111111100222012120212112220012011
110100111111111101110110111111101111111101111111111111001101101111111111111010111101101010100111111111a11100111111011011a110010100111121020120221011120102202221
010011111001100101111110111111101011111110011011110110101111111111110111201011020211200021220011222121b11111011111011111a000100111111102122122200111122202222020
011101111111111111010100111111111000111100101110101011111110101011110110122022211102212112210011121211b01011111100111110a111101101111111121112112201222122222111
011011011011111111101111101111110011111111110101011101011111111111111111222201010121202222121010120201b10111110111101111a111011110111022000120222102121200211211
011111111101111111111010111111011111111011111011111111111100011111111111001222201122101222122101112110a11110011101011110a101100110111121010211021222211201221121
001111101111111001101111111111101111110111111101011010100111110111010111112211222210210012112121120211b11111111111111111aaaaaaaaaaaaaaabbabab2212112210022121201
111111110111111101111110011111111111111000111011111101111111010111100011112210210001221122121102122201b0001101111110111100111010111011100100b0212112111212002001
111111100111100101111110111111111011110110011111111111111100001000110110221111121222212212112211200012a0011001111111110011111111111101222012a0112102112012101211
111011010011101110111111111110111111111111001110101111010111111011101111212211011101111212112210222122a0101011111111111111111111111110212122a2000021022002212201
111101111111100111110100111110110111101110111111101011110011100110111101210122112011011202201221201222a1111111111101111101011111111011212222a0211121210221111111
010101011111111101111101111111101111110110101011111111111010101011111011222022211220122111122201221211a1111111111101111111000111111111121121b0102111111120210011
010111000111111111111101111111101110010110011101111001011111111011110011221210222021220211121011102202a2221120112221002021101212212211200021b1012110211122202011
111011011111011111111111111110111100111111101011111110011101111010110111021021202101012212212122102221a2212210010220201000201121102211221110a2212121212010202011
101011111110110111110110010011100111101011111111111011111111111111111010211211122110212111222122000122b2000120102100110212002112121111211012b2220110011120202121
110110111110111110001111110111101111211022102200121112222111010112101110202122221211221020110222122121b1120210221210112022011212102211021220a1210212022121222101
aaaaaaaaaaaaaaaaaaaaaaaaaaaaaaaaaaabbbbbbbaabaaabbbabaaababbabbbaaaaaaaabbaaababa122102102221112221211a2221111011122120220022222012211121201b1122201101210212121
11111101111110111110111101110001111120102111122111222010011122122201111111222012b110100102112111210220b1211202211112122222211021211211121222a2010120110111011221
11111111111111110111010110111101100101102022120210121122211111222110111111212211b101020222222100102022b1212212122212020220120012111211222122a1110112000211211201
01111111111101100101001001110111011102122211101221221121222222111111111121112122b111211210122201121002a2112100012211012110221211212011112021b0221222102210101201
11111111010111111011110101110111111010202221122212011010111022211211110012212110a221012222112102101112a2221112021001112001200221100111202221a2122200121212211121
11011111110111111111111111111011110111122012102111122210212102211101110120221111b120100221111212212000b0121122002121221111001112211111211122b0001211111211011201
11111000000111111111111011101011010212222210200210102221212121221101111100121110a200221222201111011222a2021111210111112121202112100101202201b0222221211100112111
01110111111011111001111111111101110112122021201111111201211021101210101101222122a200122101020211020122a1201212201221011102121221211101110022b1201222222202220021
01111101011111010110011001111110011221121222201221211200001101221211111111100022b221111022022201111200b1101110021122221201120222121011011011a1101101111111111111
10111110011101111110111111101011101111120102211101202220111122100110011120221101a110101221122220022012a2012021211020211021102000111001111110a1111101011011101111
01111100101111111011111011111110111022212221112110201111201221211211101101210101a020102010102122221122b1121012012112122101122021220011101111aaaaaaaaaaaaaaaaaaaa
11111011111011111101101011100111111020222112212001021221222220011011111001101011b120111211110200121011b220111222221201210211020222111110010111111011111110111111
10111111101111111101111111111111111221111112212222112201021102111010011012122120a102112211210111021200a211100020212112122010111221121110111111111111100101111101
11110011111110101111111111111011101021101121022222110211201121122111111112102222b022111102222022021212a211211202122011121220100102111100111111111110111111111111
11110011110111101011111010111101011110112222112102011201120221112011110112202002a121222112121222100210b110101111201122211122222210201011111111110111111110001111
01111110011111110111001100010111110120210221222211011112111000122111011102022011a102212122222211221022a122210211120000101211122022210111111110111110111011111111
11111101110111111110000000111011100222012120221022221221021220210201111012122221b212102022111100211201b001221210212210201120100121020111111111101111111101110111
01111111101011111101110110111011111221021110221202022221202220220010011111111111a011111110111111110112a002211201222122210112221212021111101111011111010010111111
10111110100010110111111011010111011211201112221112011211211121110211111111011111a110110111111111101111b001211112220001120002221012021011111111111111111111111111
11011111111001111111111110100110111122021101110122102121122221121100111100111110a101100110111011111111b102220111222211210101112212001100101011111101111111111111
11111110111111111101111101111011101021111102010220222112122101102211011001111101aaaaaaaaaaaaaaaaaaaaa2b110111120112222212211102221200011111110111111011111111101
0111111010111111110111110111100110112102111211101210211012121220011110010110111011101011110011110101a2b220021122122222111121221120211011111111100111111011110101
0100111111101011111001111110011011100111221221200222222121222101211111011111100111101110111110100111a2a212001111211120121020111202111111111111111101111111111111
10111101001111111111111aaaaaaaaaaaaabaababaababaaabbaaaabbbbbbaaaaaaaaaaaaaaaaaaaaaa1111011101111101a2baabaabaaabbbabbaaaaabbaaabaaaaaaaaaaaaaaaaaaaaaaaaaaaaaaa
11111101101000011011011a11111010111222222200202212122102120121222101111111111001111a1111011111111011a00202222122222101211122221200201101111100100111111011110111
11111111111111111011111a11001010110201021200221112121012110211202211011001111111111a0110110111110110a21210020102112012122122111210210110010011111101111100111111
10110111110011111101011a11110111111211120010012211112122202112121201111111111101101a0111111110110111a10211222102202202112222211110220101111111111011111010011111
10111111111101111001110a11000111111201112200122222111221222010202101110011111000111a1110111011111101a10101101011111110111111100110110111111101001111011111111111
01111101111111111000011a11101111011120001122111000020212122222102211101110111010111a1111111110010111a11110111111100111111111111111010111001011111011110010111111
11111111111111110010100a11111101111120110111211102022120012201210111010111111111111a0111111110011111a11110111110111111010111100100110101111111011110011111011111
10101111111111111111011a11110111101111011101111111111111111111111111100111011111001a1111100111111111a11111101110111101011111111111111111111110111111111101111110
11111111001011000001010a11101111111111111111111111011110110110101111101010110111110a1100111001111111a11111011100111111111110111111011111011111111111111111000101
11011010001111111111111a11011101011011110101101111010110001101101011110111111111111a1111111111111110a11100011011010111111111101110011011111111110001110111111110
11111111111001111110110a11111111011111111111110110111111011101011110111111111110011a0111011110110110a01111111111011111111111111011110111111111111101011100101111
10111111111111111100100a10111111011011111000111011101111011011101011111111110101001a1111111111111011a01011111010111111111011110111111010110111111111011101101111
01111011001111111111100a11110110110011101111111111111111110110111111111101111111111a0111111110101111a10101111011010101110011111111011101111001111111100001111110
11111111111011101110011a11101110111110110011111111111011011011111111010001011111111a1111111011000111a01001101111110001111111111110110110101111110111111111111101
01111101011111010111111a11100111111111101111101011111110111111010110111111111101110a1111101101101110a01101110111001011111111101111111111111111111111111111101011
11111011101011101001111a11111101110111011111111011111111110111111110111010011101010a1111011111110100a11011111111111111110010111101101101101001110110111111111111
01110110111111110110111a10010111111111101011111111111111111111101110111111000101100a1101111010110111a11111010110101100111110111111001110001111001110111010010111
11101111011101111011110a10111010110111110111111011110111110111111110100000111111111a1111101111010011a11001101001111101111111111101011011111111001011011111101111
11111111110101011010100a11111111111111111011111101110011001101010111010111101111111a1111011111111001a11111010110111111101111111111101111111010110011110011111010
11101100111010101101111a10110110011111110111111011011111101111011111111110111111001a1111111111111110a10011110011111110000111110111111111111111111111111111110111
01011111111111101110111a01111101110111111111111111111111111011111011111011110111011a1111110100111101a10111011111111010110001111111111110111101011111011110111111
11111110111111011111111a10111110101101110101011111111011110101111111111011101111111a1110001111100110a01111111111101101111100101011111111111101011011100101110010
11111100111111111111111a10111111111111111011111110010101111111111110111111111110011a1111010111001111a11110101011100110111111110101111111110111111111111111111101
11111011111111110110111a10010111110110110110111111111011100111100111111111101011111a0101011101111111a01011001101000111110110101101110100100101010100111011101111
10101111111001111111111a11111111100111111100111111111101011011111011111111111111110a1111111111100111a11111111111011111111111100101111111100110111110110101111111
11001010111011111101111a10110111110101111110111111111101111100100111111011111001111a1111111111101001a11111110111011001001011111101110101111101111111111111111111
11110101110111111111110a11111111111011111111101111111000101110111111111111111111111a1111111001111111a11110111111111111110111011111111111100110110111101101101011
10111101110101111111101a00111011111010111110111111111110111101111001111111111011111a1111111111111011a11110111111110101101111011111111011111101111111111111101111
10111100110111111101111a10110101011011101111000111011111111111101111110111111011101a1011111100111111a11111100111111011111111111110111111010111111111111111110111
11111010001111001101111a01010111111110111111101110111101011111100110101011011111011a1111111111110101a10111110111111011101101011011111011011100101111111111110101
01011110111101100111011a01101010111111111111111111111111011111111111110101111110110a1111111011111110a11101101111111111111101111111111101110011111011111111111000
11111011111111110111100a11111111011111001011111101111111101111011111101111010111110a1111001110111111a11111111111111101111111111111111011101110011110111010111110
11110011101111101111111a11111111111110001011110111110111111111111111111110111111011a1111011111110111a11111111100110111111111101111111111111111111111011010011111
11011010111111111000111a11111010000111000111111111110111011111111101111001011111101a1111111111111111a01010010111101111111111111111111111111100111111111110111101
10010111101111101101101a11111111011111111011111111011111111111011111110110010110101a1111111110101111a11111111111011111110101111101111011111111101111010100110111
10111101111001111111111a11111111111111111011111111111011001110101011111001011110111a0111101100101111a11011110101111111111110111100101111111111111110011111110001
01011111111111111011110a10111111111110011101111011101011110111000010111111111101111a1101101101101110a11110111111111111111111011101011111110111011111110011001111
11111111110110111111111a11110111011111111011111110001111111111111111101111101111111a0100110011110101a01111111111111110011111101111111111111011011111101111101111
11111111111010111000110a11011110111111110111101100110001111111111110111111111011111a1101111101111011a11101110111111111111111111111110111110111110111111111111111
11111111111111101010111a01001101101010101111111101100101100101111111101110010111011a1101110100011101a11010001101111111111111010111111110101100110111101101101111
