7,104
158,111
90,108
122,22
124,8
119,97
140,82
35,115
69,68
47,87
1111100110111001110110111111100110100111111011100111110111111111010111111101101011111111110100011011111101000021100112122022001111211102100211111111111111011001
0111101111110010111011111001110111100111011101111110100111101111111101011101101111111111101110010111111001101112210121212122101101122211222101111111110110111111
1011111111110111110011111110111101111101111011110111111111011011000101111111110111010111111111011100111111111112022222222112222221220211100101111111111011111101
aaaaaaaaaaaaaaaaaaaaaaaaaaaaaaaaaaaaaaaaaaaaaaaaaaaaaaaaaaaaaaaaaaaaaaaaaaaaaaaaaaaaaaaaaaaaaaaaaaaaaaaaaaaaabaabbabababbabbbbbaababbbbabaabaaaaaaaaaaaaaaaaaaaa
1010110111011101101011111011011011111111111111111011111111001101111111110111111010111111111111101011001111110110110011201201211111100120021101111011101111111011
0111010001111011101000101011111101110011110100101111111111101011011001011011111011001111110110101111111111111102211121111012012222212220010211011110111110010111
1011011110111110111111111111111111111111111110001111111110111101010111111111100111100001111111111111111111011120222210110122021202020200102001011111110110101111
1110011111111110111011101111111100111011011111110011001111011111111111101111101111111110111010111111110011111022201011021020002022222212012011001111111111101110
1111110111111111101110110111111011111111111011011101011101111111111011111111111101011101111111111111111111012021222220220222001201022022010211110111111100111110
0111111110111111111101111111110111110111111101110111110110010011111010111101100111001111111110010111111111110200002020022000222102221102210211111101110111111111
aaaaaaaaaaaaaaaaaaaaaaaaaaaaaaaaaaaaaaaaaaaaaaaaaaaaaaaaaaaaaaaaaaaaaaaaaaaaaaaaaaaaaaaaaaaaaaaaaaaaaaaaaaabbbbbbbbabbbaaaabababbaababbbababaaaaaaaaaaaaaaaaaaaa
1111111110111101010111111111111111111110111111111111110111111111010011111111111111010111111101011111111111122222212202222012200222120120221111111111111111111010
1111110111111111110111111011011101110011111111111101111011011001101111101110101101111111111111111011111010021221022121002022220022200021211201111110111011001111
1111111011110011111101111111011111101111111111111111101111100101110111111111110111010111111011111111111111112221022012221020022110222022020201111111101111110111
1110101111110111010011110111111011111111011011111111101110111110110011011111011111001110111110111111101111111222221022202022122200020221222211101101010101111110
1111111111111111110111111111111111111100111110110111111111111111011111101111011110111111001110001101110111102010212121222022210221202122221111110010110011110100
0011111111010110111011111110100111111111011011011101101011111111111111111101111011111101010111111111101111112212222222222022222121222022001210011111101011010010
1011111111111111110010110101000111111111111110011111100111101100111110111101111111110110101111011111111010110221121211201220020012102210012111111111110100111110
1111001011110110111111011111111111111111111011011111111110101110101111001101001111010011101110111111111101102220002202122111222222220222221011111101011110111011
1110111100100111101111111111011110111111110101111110110110110111111011111110111110111011111110110111011110122202022000022121222222220112222201111101010111010110
1111110101011101101111011010111111011111111111111111110111111101111001111101111111111101011010111110111011001020221221222220212200122211221211111111111111111111
1110110101011111011111010111011111110101111011111111111101111111111111101011011111101111011100111101111110121121020221220222201102112220001011110111111011110011
1111111100110110011111110101111001001111110010111111100100111011101001111111111111101111111111011111111110012110121011122221222022211221221111111001110101101011
0111011001011111111110111100101111101100001111111111111110011110111111111010011011011110111111101101010111122020021220222220222122201022012111110011111110111110
0110111111111101101111101101111101011111111111011111101111111110011101110101111011111111001111110111011100121211201020221111022220222011211111111010011111111111
1101101001101101110101111111110111111111011111101111111110011110101011110111011010101111101111111110101111112022221011121012222111121121101111011111110111111110
1110111011111011101101111111110111110111001111110100111110111101111011111101111111111011111111111111111111121212212220012111110221121111221101101111110011100111
1110111111111111101101111111111110111101101111111111111101011100111111111111111101111110111111111111111111121211112201001122211200221100011111111101111111101111
0111111111101111011110111111011010100001111000110111111111111111101010110111010111111011101111011101111111111012110200222021222012220002111111111011111110111101
1111111110110110111111110101111011111111111110011110111111101110011011001111010111011100011101110111100100120022021002002022211121121122110001101101101111110111
1110011110010111110011111100111110101111111111111011110110000111111111111111011111111100111111110111011110110022022202210111101011221211110111011101101110101110
0101111101101111111111110101101011111110001101010101000111111111111111100101111110010111101110011110101110101012222110120112212010212121101111011111111101011111
1111111111011011110110101001111111110111101101111010111110110111111111011001001111010110010011111111110011121011210222122210002010101212021111111110001010111111
1011111101110111111110011111100111011011010111101101111111101101111110111011111001111011111011101110111111112101111201121212222121221222000111111011101110110110
0110111111111000101101111111110111111111010111111011101111111101101111110111101100110110111111101001111101000202022100022102111112121222121100110111110111100111
1001111111111111111111110111111011101111011111111111111111111111010101110011101111110111011111111111110011101101022012221102121001102112001111101100110111110001
1111111111110110101111111111111111111011111111110111110111101111010010010111111111010101000111111111100111122120112211220212201101010022101101111000111111101101
1100101010101101111101101110111010111111110100111001111001011101111110110111011110110010101111110111110101121202201011022112002120222222210110101111010011010011
1101001111111101011111011101111011101111111011110100111111011111101010111110111111111111011110110011111111111111111111011111011111111101111111111111111111100111
10011001111011111111111111111101001111111111110111101111101011111111111101101111001110110111101110001011110101111aaaaaaaaaaaaaaaaaaaaa11111111001111011101111111
01111111111111101111111101101011011001011110111111011111010011100011011111111110110111111111111111111111101111101a1011100001011011110a11111111111110011111111110
11111110101111001111011111111111111110110111111111101111110111111111111111111111011111111101101010111111111101111a0111111011010101111a01011111011101001111111110
11111111101011011011001111111111111111111101111111110111111011011110111010110111111001111100011111110111101101111a0111110101101101011a11011111110101110101111011
01111100011111011011111011111111011100111111011111111111110010111110110110111011111111111101011111010110111101111a1101111011111111101a11101111111111111011001111
01111111110111111110111011111111000110111111111011011111110101111101111101111111111111111001101111011111110100111a1110111111111110100a11111111001011110111111100
01111111111001110111101001111100111111100011111111111111101101111111000111101011111111011111111111100110111111101a1110010111011111010a11111011110111011111111111
10110111110110101111100011111110111101111111111101001110011101101011111111100001111010111111111001111111110111001a1111101011101111100a11101111111111111010001111
11111111111101101110010111111100110111000101101111111001101011111111111101111100111110101011010111100111011011101a1111111111111111011a01111111110111011111111111
11101111111111110111110111111100110101111101011111111111111111111101001110001111000111110110101101010000001011111a1111111101111110111a11111111111111110111111101
11101111111011010101111111101110111111111111001110101111001111101111110010101111101101101100111011111110111100111a1011111111111111111a01011101110111101111111010
11111011011111111111111011111011011101101010111111111111110110111110111111011111111100111111111111011110111111111a1110111111101110111a10111111011111111111111101
11111111111111011101111110111111111111111011100111111110101100110111111110101101011111111111110110110110010110110a0110100111001111010a11110101101011110111111111
11011100111111110111111010110101101111101111110001010110011111011011110011111111110111111111111010110101100111011a1110111111111111101a11111011110101111011111001
11110110010111111111111111110111111001111010101111011001121201221212112211012210022021001011110110110111111111111a1111111110111001101a11111111111111111111111101
11000101001111100111110111110000111011111011111110111121220011212022222122122021121221011111100111011111110110111a1111101111110111101a11111101111111110111011111
11111111010111111110011111111111111111111110111110111100122101220012000020102021222210111111110111111010110110010a1101111111110111110a00011101111011111111111101
11101111111111111101111101000110111101011110111111111120022110112021201121222211200111111111111111010111111101111a0111110111111010011a10111111111111101110111000
00101110111011011111110011000011111111111101001101111112121211111201021022212200112201111111111111110111111100011a1111111101110111111a11011111111111111111100101
11111111111111111101101111101111011101011111101111011101121100212101212001012221122121111010110110111010111111111a1101111010110110111a01111111011111010000111111
aaaaaaaaaaaaaaaaaaaaaaaaaaaaaaaaaaaaaaaa1110111111111112201121020022210011000222221121111111000110001111111110010a1111111101111011111aaaaaaaaaaaaaaaaaaaaa111010
111111011111111111011011111101111111110a1111111111110112021221201222110111222111012111111111110111111101101111011a111001001011010011111110111011111111111a001111
110100011111101110010111111111111111101a1111101011111111122000111202121212111211022220111111111110011110111111001a111110101111111110111111111111000010101a101111
001111110111111111011111111011101101100a1111110111111020111121111101221120210201111121111101111101110001111011111a011001011011111110111110110111100111010a101011
011011011111111111111100110111111111111a1111110110111102110022022202222020202210212210001111111011111110011111001a111111011111111110101111111101011111111a111111
111111011110111111110110110011111111111a1101011100111121110220012212201202210002101021111111110111111111111111001a101001001011111111011111111010101111111a011011
011011100010111111010110111111111001110a1111111111110122222120110121102122110221112001111011110111011111111111100a111011111111111011111111111011011011110a110010
001111111111101001111111011111110111101a1111011100111122022212122221222202221212011201111011011101101111101011011a111111111110110111111111111001111101111a011011
011111011110110111101111111010111111111a1010111111111112112012010221202020121102012111101101111101011111101111111a111111011102011212122212220222122001021a021011
101111111111001100111010111111010111001a1011011101101110222112120122221220110121202110111111111110111111111100101a101010111102110120221202010101012111021b101111
001001111111111111111100011101111101110a1101111111111101122212211022201221112002001011111101011101110111111111110a111000011112111112112221122112210001121b011111
110111101010111111111111111011011111010a1010111111101120121102222120210112221210011210111101011111101010011101011a101011011100111012220122112111120220121a211110
011101111101100111011011111101110110110a1101110111011112012121222121221010121000211021110111101111011111111111111a100100111011022112111221222020012221020b111111
101010111111110111100111110111112102020b2211121212210122220202000211012201021002112201111111111111011111111111111a111101111111121112102212111111111211120b111111
111011111011111111001111011000100102021b1011112022011221220202220011022212101022001121110011011111101111101100110a111111111112122111122122222021102222222b111011
111111110101011111101011110101110111120a2221102201121222202200212221210110202210021011111111111111111111111111101a111111011112112112211101122021100122100a201111
111111110111011001111111110111112212122b2201110212022200122202021221122112002222212121011011110111011111110101101a010111001102111212121220212010011122121b221101
111111101010101111011011111111111221120a1220110121221200021212211122001001112210111221011110110111011100010111101a111110110112220020212111212221222210202a110110
110101011101011111011101111011101211122a2220021111200021222002220112021111012112212211011110110101111110111101101a111111011011221100212101111221122021221b021011
010001001111110111111111101101111121211a1212121111010022100011011122201221111111211201001111111101111101111110101a101011011111211112202121111101211211202a211001
111111111111101111011011111111012101122b1110021211121102212112122122121022120022222221101111111010101101111111111a110111011112012202101001111120000100220babaaaa
111111111100011101111111111011101211121a1200111221201002200100221201120121222201201101111110101011111111111011111a1010111001011212222210011121121112022210200111
101011100110110111111111111111011111221b2220011221101212210200110212221221101021220101011111011110010111111010110a1111011111121112010220100102222122222111201011
111111011000101101111111101101011111212a1022021222120112222022121102020010111102222211101111111011011010212012011a1111002222122020202001111120102201202111120111
111111011111101011000111111101101122001a2112010101122200120220120222110211211212111121011111111000110111210012212b0121001112122122111211111022210122220110100110
100111111110111011111101000110112221111b2110212122101010210011011110111111111111111011111101101101110111211212222b2210211112102221221102121100222211101120121111
111111010110110111110011101111112020110a1221100122010222120212211110110111111111000111111111111101111111110210011b2112112200222102122010100220200222012122101111
111111100011001101111110110110112212202a2022211222121021110021211111101111111111111011111110111111111011001022121b2122220112222211212022212221100122212110101110
111101111110011101111111111110112122012b2211101111112011221110111111111110111111001111111011110100011101122210212a2120222022222212202220100111221021212100111110
111111111111011110111111011110111011111b2211210121200122211201210111111110100111011011011110011111111111212112210a1122021220202212221212121110011102122111021101
101001011100111111111110111111110211112a2120222122220101202210111110110111110111111101111111101111111110122011212a1202221102121220222221212201202220120020021111
111111101110111111111111110011012002122b0201222100022011111201211111110111101111110011101111101011110101000212111a1112111110202202202022122120102212100111111101
111111101011011111111111011111101111121b0121220102021211120111211011110011111111111111111101111101011101011112220b1012212002002212020010212110222211020012021111
111101111111111111101111100011001021222a0112221020010120222002210000111111111110111111111001101111111111102111221b2202211221202221121022221211211111101021021101
111111110101011110001111111011111120210b2112221212200211120120211111101111121102221112110121001122122100211120200b1001121120122022022221212020100222220000111111
011110011001001111101111101111111211012a1221120222110222121212010110011111122221121222222011201011210211211210102a2121200211222222002102221202221122100211101111
111111111111111111001110110111111001112b1002221221112012112221211101111111122212201201022111001221002212122001121b2122111221202112222222211212110102121021111000
111101010111111010011110100111111221202b0221121112102112200221111111111111100211020221121111211112012122212212211b2220111011022222200211111120100121221002211111
111001110111101111111111111111101112012a2121212212202010011211111011111011122222211211120010101210021202122211221b1222101112011222222221000221011112012101211111
110110110111100111111101110111111122112b2021220202221110121200000110011111111210112022200221111202111101012122021a2011222201220111222001111011111010111111011100
110011111111111111011000111111100011211b2212211212212121210210200101111110120102021112022211111221011111211111110b1110112021111021221121110111110111111111011111
101111111111110111001020212222121212222b2112221212200211111022111111111011011120022002222022102112122202121111221a1110222211212122221110101111111111110110111111
110111110101011111110121021212222111001b2222202022221111121222211101111110111221210120221101011112012110110212122b1120101002111122201111111111111111010101111111
111111011011011011112212212111202022201b1101220012110121221200211110011111120112021120112211221101221212001212102a1221111202122012110211111111110011111011111111
100101011110110110111110210111220222112a1101101221211101001101111111111111121221110122110212110121122202121221020a0111221211111122111020111111001010101111101110
110011110001111111111222220221121112201b1011112120211010101111111111101111101100101112022122022210212221222221201b1220220121020212122120111111101001101111111111
110111111110100101112222102102210010112a1122122111111111111111111110001010022010222201202112220222122211111010010b1102111001202212221211111111111111111110011111
101110011011111010111202222121112120211a2212222120201110111010111110111111121111122212122101110221212021020121212b0122120212202112121211101111110110111111111011
101111011111111111010112122101010121212b2201212122211010110011111111110000111122022022111200122122001220201120212a1202112121120211200200110111111101001111110111
111111111111111111110112011222001202210b0011202221011111111111110011111111111010001122212210012110202111221022112b0111122021101122010121111111111111110110011111
111110111110111111111220221012122222220b1112100111011110010011111100111101110111221111102010001121010121122221122b2012222201222111200221110111111100101111111111
111111111111110111010102121111110012222b2211112101211111111011111111101111120122012111111021020102110011221020120a1122211221222210122021111111101111111111111110
111101111111111111112111210202210210211a1102120122111110111110101111111011112221102201211221210010111012202210021a2011121112201111112111011111101101010111101110
101010111000110111102201021112120211220a2020111210110111111000101111100111021222101111200222212211012011222111212b1200211022222201121211111111111111011101111111
101110111011111111112112020121212001211b2111120210111011111111111111111011111221111112102112222220122212221111110a1111101010111101110111111111111011110110011111
101110111111101111111221020201111102111b2012201210000100111111111101001101121201122222111211111201221202100101111a1110010111111110111101111111100111111111110111
110011101011010111112002212210121100112b1102201010111011101101101110011111110022202120102010121221222121120011111a0011101011110111111111111001101101111110111101
101111111111100101102221111222021221011a2122111110211111100101101101111111122212120112022001021111211111121111010a1111111111011100110111110111101101011111111010
111111001111111110112212120202212121212a2212111211211111101111111101011111121211201122222210121211111111221111111a1111111111111111111111111101110000111111011111
101110101110111111111101110020111222000a0221221112111011111111111010101010011122012220021211211122112012100101111a0111111111110110111111111111111111101010111101
111110111100111110111111111111011111101a1110111110000111111011111101101110101101111110101001110111101111010111111a1101101111111111111110110111101110111111011001
